ROM,TIA_Count,RIOT_Count,RIOT_Timer,RIOT_IO,Branches,Jumps,Opcodes,Score
2Pak Black - Challenge - Surfing.bin,512,211,164,47,800,332,151,0.8699
2Pak Green - Hoppy - Alien Force.bin,634,193,136,57,860,255,151,0.8726
2Pak Yellow - Star Warrior - Frogger.bin,430,119,97,22,857,281,151,0.8684
32-in-1 (PAL).bin,3453,1702,1267,435,5928,1495,151,0.9417
3D Tic-Tac-Toe (1).bin,89,97,90,7,199,70,121,0.9341
3D Tic-Tac-Toe (2).bin,178,194,180,14,398,140,121,0.9341
3D Tic-Tac-Toe (32 in 1) (PAL).bin,89,97,90,7,199,71,121,0.9341
A Misterious Thief (CCE).bin,347,101,93,8,367,74,145,0.9360
A-Team.bin,314,253,216,37,583,110,151,0.9397
Acid Drop.bin,1176,514,238,276,966,566,143,0.9521
Action Man.bin,400,95,91,4,370,140,141,0.9386
Adventure.bin,156,81,38,43,345,152,140,0.9271
Adventures of Tron.bin,214,49,43,6,360,111,141,0.9484
AdventuresOnGX12.BIN,216,49,43,6,359,113,141,0.9489
Air Raid.bin,169,51,28,23,266,127,141,0.9239
Air Raiders.bin,245,31,24,7,361,98,139,0.9431
Air-Sea Battle (1).bin,100,106,82,24,212,32,125,0.9412
Air-Sea Battle (2).bin,200,212,164,48,424,64,125,0.9412
Air-Sea Battle (32 in 1) (PAL).bin,102,104,80,24,211,32,129,0.9412
Airlock.bin,321,59,54,5,305,59,129,0.9413
Alien's Return.bin,123,104,87,17,566,179,141,0.9385
Alien.bin,188,93,75,18,359,68,148,0.9370
AlligatorPeople.bin,213,82,63,19,309,80,140,0.9403
Alpha Beam with Ernie.bin,488,106,62,44,533,258,151,0.9274
Amidar.bin,299,176,172,4,331,120,135,0.9444
Angling.bin,160,62,48,14,164,28,129,0.9438
Apples and Dolls (CCE).bin,232,64,42,22,288,74,143,0.9206
Aquaventure.bin,414,131,74,57,575,172,150,0.9390
Armor Ambush.bin,139,81,57,24,247,109,139,0.9324
Artillery Duel (1).bin,389,251,197,54,643,152,146,0.9311
Assault.bin,175,99,75,24,348,132,146,0.9377
Asterix.bin,202,222,163,59,455,339,150,0.9462
ASTEROID.BIN,222,140,97,43,629,189,150,0.9543
Asteroids.bin,272,145,100,45,685,202,150,0.9323
ASTRBLST.BIN,141,46,34,12,321,163,136,0.9457
Astro War.bin,239,31,28,3,319,107,141,0.9567
Astroblast.bin,141,46,34,12,321,163,136,0.9457
Astrowar.bin,239,31,28,3,319,107,141,0.9567
Atari Video Cube.bin,288,111,85,26,303,92,140,0.9398
Atlantis (Activision) (1).bin,301,36,27,9,358,74,142,0.9391
Atlantis2.BIN,305,38,26,12,361,78,140,0.9384
Autorennen (Grand Prix).bin,305,62,57,5,292,65,135,0.9357
Bachellorette Party.bin,239,76,52,24,265,92,137,0.9542
Bachelor.bin,240,75,52,23,263,92,138,0.9528
backfire.bin,464,117,104,13,262,87,133,0.9449
Backgammon.bin,126,99,72,27,410,186,136,0.9432
Bank Heist.bin,202,103,84,19,313,132,142,0.9385
Barnstorming.bin,249,71,63,8,284,95,137,0.9396
Base Attack (PAL).bin,148,61,38,23,300,125,143,0.9326
Basic Programming.bin,119,69,61,8,304,182,142,0.9420
Basketball (32 in 1) (PAL).bin,79,45,41,4,224,14,128,0.9146
Basketball (4k version).bin,158,90,82,8,448,28,128,0.9445
Battlezone.bin,556,95,89,6,626,209,149,0.9381
Beamrider (2).bin,488,144,113,31,754,189,149,0.9401
Beany Bopper.bin,203,132,89,43,289,61,142,0.9391
Beat 'Em and Eat 'Em.bin,263,89,80,9,275,118,134,0.9341
Berenstain Bears (Coleco).bin,475,174,140,34,591,136,150,0.9348
Bermuda Triangle.bin,217,80,51,29,365,63,144,0.9429
Bermuda.bin,199,56,49,7,382,89,144,0.9364
Berzerk.bin,214,63,45,18,277,182,138,0.9464
berzerkvoice.bin,416,160,117,43,358,232,151,0.9129
Bi! Bi! (PAL).bin,163,142,104,38,358,125,142,0.9482
Big Bird's Egg Catch.bin,645,146,116,30,541,205,150,0.9408
Bionic Breakthrough.bin,244,126,107,19,697,183,149,0.9417
Blackjack (1).bin,81,43,32,11,202,47,135,0.9392
Blackjack (2).bin,162,86,64,22,404,94,135,0.9392
Blackjack (32 in 1) (PAL).bin,81,43,32,11,202,47,135,0.9391
BloodyHumanFreeway_NTSC.bin,175,63,38,25,135,45,126,0.9476
Blueprint.bin,415,88,68,20,685,188,144,0.9358
BMX Airmaster.bin,869,478,356,122,1183,467,151,0.9319
Bobby is Going Home (CCE).bin,276,131,79,52,236,80,143,0.9311
Bogey Blaster.bin,245,31,24,7,361,98,139,0.9432
Boggle.bin,97,95,72,23,159,67,121,0.9158
Boom Bang.bin,363,100,75,25,304,74,146,0.9378
Bowling (1).bin,99,50,45,5,192,36,129,0.9429
Bowling (2).bin,98,50,45,5,192,36,129,0.9426
Bowling (32 in 1) (PAL).bin,99,50,45,5,192,37,129,0.9429
Bowling (4k version).bin,198,100,90,10,384,72,129,0.9429
Boxing (1).bin,96,42,28,14,186,45,135,0.9421
Boxing (2).bin,192,84,56,28,372,90,135,0.9421
Boxing (32 in 1) (PAL).bin,96,42,28,14,184,45,133,0.9432
Brain Games (1).bin,61,32,22,10,165,61,130,0.9346
Brain Games (2).bin,122,64,44,20,330,122,130,0.9346
Breakdown.bin,141,115,109,6,374,95,144,0.9354
Breakout - Breakaway IV (1).bin,91,33,30,3,179,58,128,0.9390
Breakout - Breakaway IV (2).bin,182,66,60,6,358,116,128,0.9390
Brick Kick.bin,194,68,60,8,361,103,146,0.9398
Bridge.bin,79,132,119,13,495,113,142,0.9460
Buck Rogers - Planet of Zoom.bin,407,178,143,35,607,179,149,0.9403
Bugs Bunny.bin,261,84,61,23,508,162,150,0.9321
Bugs.bin,209,54,39,15,297,131,130,0.9481
Bumpnjump.bin,398,86,74,12,524,192,149,0.8343
Burgertime.bin,453,106,95,11,778,322,151,0.9318
Burning Desire.bin,175,81,66,15,386,91,146,0.9357
Cakewalk.bin,345,63,52,11,301,139,144,0.9358
California Games.bin,732,202,163,39,1263,395,151,0.9369
Canyon Bomber (4k version).bin,270,142,116,26,300,82,132,0.9485
Carnival.bin,219,78,64,14,377,67,146,0.9408
Casino.bin,141,94,76,18,362,93,144,0.9375
Cat Trax.bin,251,98,77,21,327,154,140,0.9454
Cathouse Blues.bin,237,127,93,34,306,123,140,0.9296
Catmouse.bin,251,98,77,21,327,154,140,0.9454
Centipede.bin,517,160,98,62,621,183,149,0.9430
Challenge (Alt).bin,388,173,132,41,694,293,149,0.9435
Challenge of...NEXAR.bin,165,53,46,7,347,69,139,0.9572
Chase the Chuckwagon.bin,258,133,125,8,214,124,142,0.9313
Checkers (32 in 1) (PAL).bin,88,52,46,6,179,101,125,0.9485
Checkers (Activision).bin,88,52,46,6,181,101,129,0.9475
China Syndrome.bin,183,94,79,15,277,86,141,0.9385
Chopper Command (CCE).bin,255,76,58,18,403,83,147,0.9438
Chuck Norris Superkicks.bin,274,123,94,29,673,201,149,0.9385
Chuckick.bin,274,123,94,29,673,201,149,0.9385
Chuckwgn.bin,258,133,125,8,214,124,142,0.9313
Circus Atari.bin,148,33,31,2,264,65,145,0.9620
Circus-j.bin,151,34,32,2,273,76,145,0.9603
climber5_NTSC.bin,241,74,69,5,343,78,145,0.9343
Clown Downtown (PAL).bin,199,104,84,20,209,162,145,0.9250
Coconuts.bin,220,79,66,13,368,103,143,0.9273
Code Breaker (1).bin,105,134,101,33,178,38,132,0.9463
Code Breaker (2).bin,210,268,202,66,356,76,132,0.9463
Coke Wins.bin,229,50,45,5,317,104,139,0.9409
Coln.bin,123,104,87,17,565,179,141,0.9393
Color Bar Generator.bin,312,115,87,28,176,106,149,0.9138
Colors Demo.bin,18,8,6,2,8,1,29,0.2782
Combat (32 in 1) (PAL).bin,101,51,32,19,176,52,138,0.9342
Combat - Tank Plus (4k Version).bin,194,102,64,38,350,108,135,0.9340
combat2.bin,346,32,24,8,465,241,147,0.9533
Commando Raid.bin,252,99,94,5,362,91,140,0.9417
Commando.bin,752,356,334,22,653,416,148,0.9288
Concentration.bin,71,19,16,3,175,23,127,0.9365
Condor Attack.bin,319,86,83,3,276,68,142,0.9431
CONDOR.BIN,319,86,83,3,276,68,142,0.9431
confrontation.bin,225,136,99,37,411,126,141,0.9394
Congbong.bin,543,117,102,15,793,180,149,0.9402
Congo Bongo.bin,543,117,102,15,793,180,149,0.9402
Conquest of Mars.bin,799,229,193,36,1459,491,151,0.9406
Cookie Monster Munch.bin,409,199,167,32,551,151,150,0.9329
Corrida da Matematica (CCE).bin,111,106,86,20,408,116,138,0.9394
Cosmic Ark (CCE).bin,218,59,54,5,409,100,141,0.9500
Cosmic Commuter.bin,299,63,54,9,387,77,148,0.9423
Cosmic Corridor.bin,192,91,81,10,818,114,140,0.9541
Cosmic Creeps.bin,174,66,24,42,234,129,140,0.9432
Cosmic Swarm (32 in 1) (PAL).bin,105,21,16,5,181,46,119,0.9293
Cosmic Swarm (4k Version).bin,206,42,32,10,362,92,119,0.9293
Cosmic Swarm.bin,103,21,16,5,181,46,119,0.9293
Cracked.BIN,1046,260,207,53,819,266,151,0.9306
Crackpots.bin,361,98,74,24,322,76,147,0.9395
Crash Dive.bin,227,100,70,30,369,100,150,0.9398
Crazy Climber.bin,413,173,134,39,646,217,150,0.9355
crazyballoon-ntsc.bin,145,52,44,8,395,55,143,0.9205
CrazyValet.bin,184,45,41,4,247,56,122,0.9122
Criminal Pursuit.bin,347,101,93,8,367,68,144,0.9370
Cross Force.bin,173,67,52,15,320,135,141,0.9413
Crossbow.bin,1257,271,220,51,1412,426,151,0.9364
Cruise Missile.bin,268,60,54,6,350,106,130,0.9506
Crusmisl.bin,268,60,54,6,350,106,130,0.9506
Crypts of Chaos.bin,134,35,32,3,365,77,145,0.9308
Crystal Castles.bin,288,188,140,48,954,381,151,0.9379
Cubicolor.bin,392,96,70,26,345,104,136,0.9452
Cubo Magico (CCE).bin,391,93,70,23,343,106,135,0.9449
Custerev.bin,162,43,36,7,1122,99,134,0.9562
Dancing Plate (PAL).bin,214,110,87,23,452,116,141,0.9390
Darkcham.bin,504,273,252,21,1279,271,151,0.9145
Darkcvrn.bin,200,79,38,41,321,123,143,0.9391
darkmage.bin,161,79,71,8,247,170,128,0.9155
Deadly Duck.bin,337,71,50,21,275,69,138,0.9460
Death Trap.bin,317,108,81,27,307,161,143,0.9415
Decathlon.bin,456,132,107,25,778,117,149,0.9418
Defender 2 (16K version).bin,490,288,254,34,1604,288,151,0.9424
Defender 2.bin,245,144,127,17,802,144,151,0.9423
Defender.bin,155,90,55,35,398,94,141,0.9438
Demolition Herby.bin,156,63,58,5,288,95,137,0.9358
Demon Attack (Activision).bin,176,76,41,35,414,111,145,0.9428
Demons to Diamonds.bin,183,53,43,10,389,75,145,0.9449
Desert Falcon.bin,355,211,163,48,1342,290,151,0.9343
Dethstar.bin,376,228,210,18,716,260,150,0.9395
Dice Puzzle.bin,155,91,76,15,299,153,141,0.9491
Dig Dug.bin,629,261,183,78,1748,410,151,0.9355
Dishastr.bin,195,90,71,19,289,100,143,0.9290
Dodge Em.bin,203,145,113,32,431,201,140,0.9467
Dolphin.bin,302,82,77,5,424,105,143,0.9459
Donald Duck's Speedboat.bin,276,119,108,11,473,94,148,0.9345
Donkey Kong Jr. (CCE).bin,651,78,58,20,696,204,147,0.9411
Donkey Kong.bin,180,79,56,23,344,57,145,0.9461
Double Dragon.bin,488,251,189,62,1272,378,151,0.9290
Double Dunk.bin,857,416,348,68,1376,415,151,0.9406
Dragon Defender.bin,189,106,81,25,380,106,138,0.9440
Dragonfire.bin,209,88,61,27,389,69,143,0.9399
Dragster (1).bin,123,39,33,6,149,35,138,0.9445
Dragster (2).bin,246,78,66,12,298,70,138,0.9445
Drgndfnd.bin,189,106,81,25,380,106,138,0.9440
Dschungle Boy (Pitfall).bin,245,79,61,18,307,59,142,0.9401
Duck Shoot (PAL).bin,230,38,31,7,378,146,144,0.9414
Dukes of Hazzard.bin,444,365,229,136,842,343,151,0.9366
dukes_v2.bin,174,156,108,48,314,60,119,0.9375
Dumbo's Flying Circus.bin,199,120,94,26,560,211,151,0.9281
dune.bin,174,69,53,16,299,83,147,0.9567
E.T..bin,267,252,199,53,702,163,150,0.9328
Earth Dies Screaming.bin,247,69,45,24,318,53,147,0.9437
Eggomania.bin,139,66,28,38,307,105,142,0.9311
ElevatorAction.bin,362,154,129,25,718,109,149,0.9519
Eliladdr.bin,374,76,66,10,255,77,143,0.9398
Elk Attack.bin,293,112,96,16,390,149,150,0.9408
Encounter at L5.bin,187,84,82,2,268,51,140,0.9382
Enduro.bin,277,88,55,33,287,72,144,0.9437
Entity.BIN,259,94,75,19,318,83,143,0.9398
Entombed.bin,172,72,67,5,367,125,131,0.9509
Espial.bin,42,141,100,41,444,193,148,0.8842
Euchre.bin,235,88,79,9,360,119,141,0.9412
EuchrePAL.bin,235,89,79,10,363,119,141,0.9418
Ewok Adventure (Parker Bros, Thomas Jentzsch) (NTSC).bin,297,107,89,18,772,270,151,0.9349
Ewokadvn.bin,300,107,89,18,776,265,151,0.9336
Exocet.bin,263,60,54,6,342,101,127,0.9516
F-14 Tomcat Flight Simulator.bin,734,203,174,29,1533,351,151,0.9363
falldown_ntsc.bin,280,93,77,16,395,211,146,0.9029
Fantastic Voyage.bin,213,51,45,6,458,56,130,0.9482
Farmyard Fun.bin,299,53,49,4,281,133,140,0.9365
Fast Eddie.bin,227,56,48,8,299,50,139,0.9398
Fast Food.bin,148,65,52,13,298,143,139,0.9271
Fatal Run.bin,1223,504,376,128,1844,1033,151,0.9405
Fathom.bin,306,182,154,28,789,183,150,0.9438
Fighterp.bin,734,203,174,29,1533,351,151,0.9363
Final Approach.bin,308,70,50,20,358,101,143,0.9485
Fire Birds.bin,176,99,79,20,349,128,146,0.9375
Fire Fighter.bin,285,90,82,8,422,80,139,0.9360
Fire Fly.bin,179,103,89,14,373,175,140,0.9406
Fire Spinner.bin,354,93,62,31,327,88,147,0.9406
Fishing Derby (16k Version).bin,1280,496,384,112,1336,232,132,0.9430
Fishing Derby (32 in 1) (PAL).bin,160,62,48,14,164,28,130,0.9438
Fishing Derby (pirate) (32 in 1) (PAL).bin,160,64,50,14,166,26,130,0.9434
Flag Capture (32 in 1) (PAL).bin,74,73,38,35,184,68,125,0.9486
Flag Capture.bin,74,73,38,35,184,67,124,0.9485
FlapPing.bin,197,109,95,14,221,76,132,0.9128
Flash Gordon.bin,245,112,95,17,364,54,144,0.9494
Flashgrd.bin,245,112,95,17,364,54,144,0.9494
Football (1).bin,105,44,33,11,185,42,130,0.9319
Football (2).bin,210,88,66,22,370,84,130,0.9319
Football (32 in 1) (PAL).bin,105,44,33,11,185,42,131,0.9319
Foozball.bin,216,100,94,6,261,126,132,0.9324
Forest (PAL).bin,277,70,47,23,355,108,141,0.9384
fotr.bin,98,64,61,3,202,61,127,0.9060
Frankenstein's Monster.bin,316,113,83,30,374,97,140,0.9456
Freeway (1).bin,174,65,40,25,148,43,127,0.9503
Freeway (2).bin,348,130,80,50,296,86,127,0.9503
Freeway (32 in 1) (PAL).bin,174,65,40,25,146,43,124,0.9512
Freeway (pirate) (32 in 1) (PAL).bin,175,65,40,25,143,43,124,0.9492
Frogflys.bin,116,50,38,12,286,93,141,0.9211
Frogger II - Threedeep!.bin,301,65,59,6,662,313,147,0.9398
Frogger.bin,133,28,23,5,359,103,149,0.9379
Frogpond.bin,266,34,17,17,589,182,148,0.9608
Frontline.bin,276,135,96,39,610,213,151,0.9350
Frostbite.bin,283,83,71,12,340,69,146,0.9392
Fun with Numbers (32 in 1) (PAL).bin,75,56,39,17,179,64,127,0.9475
Fun With Numbers.bin,75,56,39,17,179,64,126,0.9474
G.I. Joe - Cobra Strike.bin,401,93,89,4,372,137,141,0.9379
Galaga.bin,200,62,53,9,367,67,144,0.9365
Galaxian.bin,676,302,289,13,716,132,147,0.9371
Game of Concentration.bin,71,19,16,3,175,23,127,0.9365
Gangster Alley.bin,175,106,96,10,299,114,144,0.9413
garfield.bin,251,164,139,25,340,249,151,0.8511
Gas Hog.bin,291,86,69,17,369,45,145,0.9464
Gauntlet.bin,214,128,75,53,360,69,141,0.9391
Ghost Manor (1).bin,187,63,57,6,254,78,146,0.9247
Ghost Manor (2).bin,297,125,114,11,553,261,149,0.9393
Ghostbusters II.bin,543,257,224,33,790,217,149,0.9542
Ghostbusters.bin,510,122,81,41,738,164,149,0.9338
Ghostman.bin,297,125,114,11,553,261,149,0.9393
Gigolo.bin,236,127,93,34,314,125,139,0.9316
Glacier Patrol.bin,152,73,65,8,291,59,140,0.9457
Glib.bin,221,54,31,23,292,194,146,0.9351
GoFish_NTSC.bin,270,157,126,31,444,155,150,0.9141
Golf (1).bin,100,25,20,5,190,30,143,0.9429
Golf (2).bin,200,50,40,10,380,60,143,0.9429
Golf (32 in 1) (PAL).bin,100,23,19,4,189,30,143,0.9427
Golf.bin,100,25,20,5,190,30,143,0.9429
Gopher.bin,175,64,53,11,290,123,143,0.9314
Gorf.bin,265,131,94,37,399,120,136,0.9415
Grand Prix (16k Version).bin,1220,256,228,28,1192,244,138,0.9353
Gravitar.bin,324,170,159,11,733,179,150,0.9375
Great Escape.bin,160,78,59,19,332,174,143,0.9470
Gremlins.bin,378,196,142,54,549,215,150,0.9350
Grover's Music Maker.bin,328,133,105,28,354,176,148,0.9248
Guardian.bin,349,110,88,22,357,119,137,0.9464
GUNNTSC.bin,129,65,43,22,293,87,144,0.9169
Gyruss.bin,131,84,66,18,594,172,149,0.9110
H.E.R.O..bin,335,86,68,18,725,181,151,0.9270
Halloween.bin,189,62,35,27,361,103,139,0.9470
Hangman.bin,110,24,14,10,226,91,143,0.9124
Harbor Escape.bin,199,55,47,8,355,68,145,0.9374
Haunted House.bin,125,87,65,22,469,110,143,0.9404
Hole Hunter.bin,163,85,63,22,321,86,142,0.9360
Holey Moley.bin,353,65,41,24,341,107,146,0.9509
Home Run Baseball (1).bin,94,82,77,5,225,28,138,0.9413
Home Run Baseball (2).bin,188,164,154,10,450,56,138,0.9413
Homerun (32 in 1) (PAL).bin,94,82,77,5,225,28,138,0.9413
Human Cannonball (32 in 1) (PAL).bin,111,51,37,14,164,85,139,0.9390
Human Cannonball - Cannon Man (1).bin,110,51,37,14,164,84,138,0.9390
Human Cannonball - Cannon Man (2).bin,220,102,74,28,328,168,138,0.9390
I Want My Mommy.bin,232,64,42,22,297,74,141,0.9210
I.Q. 180.bin,270,87,78,9,219,140,138,0.9369
Ice Hockey.bin,227,90,71,19,403,76,142,0.9459
Ikari Warriors.bin,793,160,129,31,1138,253,149,0.9189
Imagic Selector.bin,439,73,60,13,231,84,137,0.9388
Immies and Aggies.bin,227,107,95,12,343,76,137,0.9424
IncaGold_Zellers.BIN,173,83,75,8,313,169,139,0.9466
Indy 500 (4k Version).bin,148,114,78,36,304,130,130,0.9376
Infiltrate.bin,130,40,29,11,278,60,143,0.9473
International Soccer.bin,216,100,94,6,261,127,132,0.9323
INV+.bin,228,119,90,29,267,77,141,0.9451
INV.bin,223,96,72,24,222,74,129,0.9128
Iq180.bin,270,87,78,9,219,140,138,0.9369
Ixion.bin,223,50,39,11,636,148,150,0.9471
James Bond 007.bin,536,176,59,117,668,224,148,0.9405
Jammed.bin,134,65,57,8,236,96,150,0.9161
Jawbreaker.bin,202,155,137,18,427,120,138,0.9408
Jediaren.bin,281,103,73,30,294,86,140,0.9364
Journey Escape.bin,200,125,92,33,397,93,140,0.9373
Joust.bin,336,175,120,55,819,153,150,0.9422
JoustPong.bin,203,103,95,8,196,69,132,0.9266
Jrpacman.bin,561,322,232,90,994,345,151,0.9203
Jungle Fever.bin,179,79,64,15,377,92,148,0.9387
Jungle Hunt.bin,517,165,135,30,838,130,149,0.9420
Kaboom! (1).bin,147,49,44,5,183,39,130,0.9415
Kaboom! (2).bin,294,98,88,10,366,78,130,0.9415
kamisauc.bin,246,54,47,7,346,105,127,0.9545
Kangaroo.bin,438,167,129,38,637,131,149,0.9360
Karate.bin,223,120,110,10,267,224,142,0.9344
Keystone Kapers.bin,256,78,39,39,343,74,145,0.9368
King Kong.bin,195,75,66,9,383,119,144,0.9456
Klax.bin,912,341,323,18,1763,465,151,0.9436
Knight on the Town.bin,223,91,67,24,361,91,144,0.9499
Kool Aid Man.bin,255,99,95,4,300,119,141,0.9417
Krull.bin,333,163,140,23,773,200,151,0.9405
Kung Fu Master.bin,367,169,141,28,764,263,150,0.9366
Kung Fu.bin,259,122,112,10,278,245,140,0.9406
labyrinth.bin,331,138,116,22,471,120,150,0.9534
Lady in Wading.bin,226,93,69,24,347,89,144,0.9494
Laser Blast (1).bin,159,48,34,14,175,27,121,0.9399
Laser Blast (2).bin,318,96,68,28,350,54,121,0.9399
Laser Blast (32 in 1) (PAL).bin,159,48,34,14,173,27,119,0.9409
Laser Gates.bin,202,98,69,29,411,83,149,0.9421
LASRGATE.BIN,202,98,69,29,411,83,149,0.9421
Lasrvoly.bin,200,98,69,29,416,83,149,0.9426
lochjaw.bin,214,35,24,11,439,63,146,0.9515
Lock n Chase.bin,202,41,33,8,369,108,142,0.9340
London Blitz.bin,376,126,115,11,360,138,145,0.9408
Looping.BIN,397,138,74,64,761,236,150,0.9351
LordOfTheRings.bin,399,179,160,19,792,253,149,0.9377
LOSTLUGG.BIN,272,67,36,31,336,126,140,0.9496
M.A.D..bin,172,131,71,60,347,107,146,0.9476
M.A.S.H..bin,200,83,72,11,314,60,146,0.9367
magicard.bin,73,69,62,7,170,87,140,0.9344
Malagai.bin,196,25,21,4,416,124,145,0.9385
Mangia.bin,264,96,79,17,280,98,141,0.9296
Marauder.bin,193,105,60,45,389,85,139,0.9409
Marine Wars.bin,143,54,26,28,417,143,145,0.9378
Marineflieger (PAL).bin,261,47,39,8,316,117,140,0.9495
MARIOBRO.BIN,401,171,152,19,496,244,150,0.9401
Master Builder.bin,148,50,44,6,352,159,143,0.9394
Masters of the Universe - The Power of He-Man.bin,670,256,211,45,888,302,150,0.9330
Math Gran Prix.bin,113,107,87,20,409,110,140,0.9402
Maze Craze.bin,229,22,18,4,325,133,132,0.9468
McDonalds.bin,145,72,51,21,395,143,143,0.9400
mc_ntsc_7_26_3.bin,1082,136,107,29,1051,393,151,0.9160
mc_pal_4_28_3.bin,1082,126,97,29,1066,428,151,0.9159
Mega Force.bin,147,82,52,30,406,65,150,0.9370
Megamania.bin,319,56,53,3,319,100,141,0.9403
Meltdown.bin,227,77,72,5,315,92,144,0.9386
Meteor Defence.bin,242,33,30,3,317,99,140,0.9554
Midnight Magic.bin,683,171,123,48,843,332,150,0.9330
Millipede.bin,632,259,240,19,1325,393,151,0.9474
MindMaze.bin,373,80,75,5,312,125,134,0.9622
Miner 2049er.bin,158,162,105,57,602,488,148,0.9388
Mines of Minos.bin,174,102,89,13,400,109,144,0.9418
Minesweeper.bin,167,85,80,5,132,32,125,0.8477
Miniature Golf (32 in 1) (PAL).bin,79,66,42,24,194,37,128,0.9397
Miniature Golf - Arcade Golf (1).bin,78,67,43,24,195,37,131,0.9406
Miniature Golf - Arcade Golf (2).bin,156,134,86,48,390,74,131,0.9406
MINRVOL2.BIN,152,98,87,11,647,445,148,0.9403
MIN_GOLF.BIN,78,67,43,24,195,37,131,0.9406
Missile Command.bin,135,133,96,37,373,93,145,0.9427
Missile Control.bin,233,102,67,35,288,131,140,0.9487
Mission 3000 A.D..bin,200,67,58,9,421,93,147,0.9460
Misspig.bin,206,79,65,14,350,109,130,0.9625
Mogul Maniac.bin,244,105,75,30,352,59,144,0.9349
MondoPong.bin,193,81,63,18,192,103,139,0.9082
Monstercise.bin,175,35,32,3,187,101,135,0.9392
Montezuma's Revenge.bin,363,130,108,22,768,255,150,0.9343
Moon Patrol.bin,500,287,250,37,621,197,151,0.9415
Moonsweeper.bin,272,172,84,88,609,164,149,0.9375
Moto Laser (CCE).bin,147,82,52,30,406,65,150,0.9370
Motocross Racer - Joystik.bin,430,201,171,30,655,233,148,0.9366
Motocross Racer.bin,429,202,172,30,687,233,148,0.9362
Motocross.bin,189,72,62,10,282,105,148,0.9435
Motorodeo.bin,619,318,252,66,967,527,151,0.9501
Mouse Trap.bin,144,36,28,8,350,104,141,0.9463
Mr. Do!'s Castle.bin,268,195,136,59,647,202,146,0.9340
Mr. Do!.bin,327,142,131,11,681,255,150,0.9357
Mr. Postman.bin,255,114,94,20,424,116,142,0.9378
Ms. Pac-Man.bin,353,163,135,28,695,147,150,0.9450
MTNKING.BIN,357,69,58,11,883,169,151,0.9187
Multi-Sprite Demo.bin,206,82,70,12,390,96,139,0.8518
Music Machine.bin,198,56,51,5,228,50,138,0.9186
My Golf.bin,341,186,154,32,470,186,151,0.9333
NAMEGAME.BIN,223,29,23,6,300,94,144,0.9299
Nexar.bin,165,53,46,7,347,69,139,0.9572
NGHTMARE.BIN,127,32,18,14,359,151,144,0.9352
Night Driver (4k Version).bin,252,224,168,56,382,72,129,0.9413
Night Stalker.bin,197,79,38,41,325,123,143,0.9399
Nightmare.bin,127,32,18,14,359,151,144,0.9352
No Escape! (1).bin,225,63,47,16,400,85,147,0.9429
Nuts.bin,164,74,53,21,196,67,136,0.9180
Obelix.bin,206,125,108,17,528,216,150,0.9456
Ocean City Defender.bin,302,39,28,11,353,74,144,0.9395
Octopus.bin,223,29,23,6,300,94,144,0.9299
Off Your Rocker.bin,225,98,83,15,347,102,134,0.9396
Ofthwall.bin,714,182,140,42,1446,330,151,0.9334
Oink!.bin,266,102,85,17,403,70,143,0.9401
Okie Dokie.bin,100,55,48,7,180,64,121,0.9489
Omegarac.bin,280,129,109,20,729,232,149,0.9327
Open Sesame.bin,245,52,48,4,411,122,141,0.9370
Oscar's Trash Race.bin,496,128,107,21,513,233,150,0.9393
Othello (32 in 1) (PAL).bin,100,27,24,3,226,61,136,0.9398
Out of Control.bin,190,91,53,38,354,112,145,0.9260
Outerspc.bin,68,53,37,16,203,34,123,0.9403
Outlaw (32 in 1) (PAL).bin,101,41,31,10,145,51,126,0.9436
Outlaw - GunSlinger (2).bin,202,82,62,20,290,102,126,0.9436
Oystron.bin,197,123,116,7,332,67,145,0.9379
Pac Kong.bin,173,83,75,8,313,169,139,0.9466
Pac-Man.bin,208,70,65,5,366,170,139,0.9391
Pac-Space.bin,208,70,65,5,366,170,140,0.9392
Panda Chase.bin,197,75,68,7,290,81,148,0.9290
Parachute.bin,212,105,84,21,300,129,149,0.9352
Peek-A-Boo.bin,177,71,68,3,312,107,145,0.9446
Pele's Championship Soccer (pirate).bin,171,75,51,24,432,101,145,0.9361
Pele's Championship Soccer.bin,174,74,50,24,434,100,143,0.9369
Pele.bin,174,74,50,24,434,100,143,0.9369
Pengo.bin,340,120,102,18,509,148,150,0.9423
Pete Rose Baseball.bin,676,418,306,112,1179,304,151,0.9459
Phantom Tank (PAL).bin,172,65,56,9,487,155,141,0.9482
phantompanzer.bin,172,65,56,9,487,155,141,0.9482
Pharoah's Curse.bin,189,39,25,14,299,179,137,0.9463
Philly Flasher.bin,254,91,81,10,526,115,136,0.9457
Phoenix.bin,415,205,174,31,766,105,147,0.9406
Pick 'n Pile.bin,925,248,223,25,975,697,147,0.9487
PickUp.BIN,248,69,54,15,317,88,147,0.9365
Picnic.bin,183,119,94,25,288,163,136,0.9441
Piece o' Cake.bin,330,110,64,46,318,130,137,0.9359
Pigs in Space.bin,331,108,98,10,674,175,151,0.9315
Pitfall II - Lost Caverns (10K version).bin,594,116,81,35,828,197,151,0.9174
Pitfall! No Walls Hack.bin,244,81,62,19,326,59,145,0.9373
Pitfall!.bin,244,81,62,19,326,59,143,0.9374
PizzaChef.bin,265,117,86,31,343,120,144,0.9325
Planet Patrol.bin,320,73,58,15,351,101,135,0.9476
PlanetOfTheApes.bin,130,42,27,15,321,72,137,0.9395
Plaque Attack.bin,231,73,64,9,338,97,146,0.9412
Pleiades.bin,612,165,125,40,686,224,148,0.9453
poker_squares.bin,370,51,41,10,231,31,137,0.9117
Polaris.bin,51,142,118,24,522,443,150,0.9380
Pole Position.bin,492,104,90,14,566,97,151,0.9355
Polo.bin,75,40,25,15,222,47,134,0.9425
Pompeii.bin,229,42,33,9,250,87,139,0.9357
Pooyan.bin,160,61,33,28,401,147,149,0.9380
Popeye.bin,333,144,112,32,607,186,151,0.9473
Porky's.bin,284,121,96,25,663,287,149,0.9359
pressgge.bin,109,61,50,11,99,32,92,0.8964
Pressure Cooker.bin,496,110,104,6,541,133,150,0.9409
Private Eye.bin,367,118,103,15,564,143,150,0.9385
Puzzle (Taiwan).bin,229,22,18,4,325,133,133,0.9468
Pyramid War.bin,250,78,58,20,405,76,146,0.9461
Q-bert's Qubes (2).bin,361,157,129,28,512,234,151,0.9326
Q-bert.bin,276,88,70,18,307,67,143,0.9385
qb215NTSC.bin,152,60,43,17,297,156,146,0.9360
qb215PAL.bin,154,60,43,17,299,155,145,0.9377
qb215STELLA.bin,152,60,43,17,297,156,146,0.9361
Quadrun.bin,359,176,148,28,482,209,151,0.9355
Quest for Quintana Roo.bin,423,56,52,4,548,250,151,0.9425
Quick Step!.bin,290,84,44,40,348,120,140,0.9439
Rabbittr.bin,573,116,86,30,458,285,148,0.9426
Racquetball.bin,427,107,82,25,313,66,144,0.9457
Radarlok.bin,617,220,177,43,1261,352,151,0.9194
Raft Rider.bin,264,129,109,20,278,65,136,0.9467
Raiders of the Lost Ark.bin,225,164,143,21,734,172,151,0.9351
Rainbow Invaders NTSC.bin,220,100,87,13,376,110,138,0.9448
Ram It.bin,264,42,37,5,399,112,135,0.9433
Rampage!.bin,496,186,138,48,1216,557,151,0.9261
Reactor.bin,156,87,64,23,419,71,140,0.9471
RealSports Baseball.bin,362,252,206,46,766,237,150,0.9462
RealSports Boxing.bin,757,290,221,69,600,231,149,0.8850
RealSports Football.bin,289,147,88,59,784,244,150,0.9354
RealSports Soccer.bin,269,148,139,9,425,219,146,0.9503
RealSports Tennis (1).bin,517,199,81,118,592,167,146,0.9312
RealSports Volleyball.bin,188,99,80,19,357,80,146,0.9448
Rescue Bira Bira.bin,178,83,67,16,377,97,144,0.9388
Rescue Terra I.bin,151,70,50,20,409,71,143,0.9418
Resgate Espacial (CCE).bin,272,169,84,85,609,166,149,0.9373
Revenge of the Beefsteak Tomatoes.bin,287,101,84,17,342,144,141,0.9463
RevengeOfTheApes.bin,207,72,43,29,452,121,151,0.9104
Riddle of the Sphinx.bin,171,90,76,14,511,94,142,0.9451
River Patrol.bin,64,116,64,52,690,209,149,0.9391
River Raid (16k Version).bin,800,232,200,32,1460,264,144,0.9338
River_tw.bin,200,57,49,8,361,66,144,0.9354
Rivraid2.bin,861,215,178,37,823,278,151,0.9385
Road Runner.bin,745,190,139,51,1133,317,151,0.9478
Robin Hood.bin,280,117,95,22,569,245,149,0.9374
robnhood.bin,280,117,95,22,569,245,149,0.9374
Robot Fight.bin,128,128,91,37,374,96,145,0.9446
Robot Tank.bin,481,94,89,5,498,149,150,0.9354
Roc n' Rope.bin,281,214,111,103,670,258,149,0.9364
Room of Doom.bin,243,112,98,14,370,95,139,0.9384
RubiksCube3D.bin,295,137,113,24,217,76,142,0.9249
RushHour.BIN,224,82,59,23,263,104,136,0.9388
Saboteur.bin,315,251,212,39,585,102,151,0.9393
sagent.bin,225,63,61,2,370,81,144,0.9370
Save Our Ship.bin,295,100,88,12,305,103,136,0.9269
SaveMary_NTSC.bin,458,306,286,20,794,305,151,0.9455
SaveTheWhales.BIN,175,33,27,6,291,58,132,0.9611
scsi130-cge2k1.bin,193,51,45,6,156,149,132,0.8694
scsi130sp-cge2k1.bin,193,51,45,6,156,149,132,0.8694
scsi200_NTSC.bin,228,63,60,3,183,90,133,0.8760
SCUDIV_P.BIN,157,127,103,24,373,138,142,0.9465
Sea Hawk (CCE).bin,259,43,34,9,310,108,136,0.9488
Sea Hunt.bin,157,128,104,24,374,138,142,0.9466
Sea Monster (PAL).bin,242,101,90,11,345,66,140,0.9451
seantsc.bin,180,68,52,16,276,101,141,0.9330
Seaquest.bin,352,75,62,13,360,83,145,0.9372
SECRETQ.BIN,769,249,177,72,1440,344,151,0.9240
Seesaw (Taiwan).bin,149,34,32,2,273,76,145,0.9595
Sentinel.bin,490,331,252,79,832,251,151,0.9305
Shark Attack.bin,209,35,24,11,451,66,144,0.9498
shootacd.bin,695,312,253,59,881,390,151,0.9150
Shootin' Gallery.bin,292,61,48,13,290,71,147,0.9374
Shuttle Orbiter.bin,180,47,35,12,287,102,137,0.9330
Sinistar.bin,221,132,101,31,387,158,147,0.9536
Sir Lancelot.bin,415,216,193,23,503,257,148,0.9430
Skateboardin'.bin,292,65,49,16,609,145,147,0.9209
Skeet Shoot (1).bin,109,39,25,14,223,43,121,0.9463
Skeet Shoot (2).bin,218,78,50,28,446,86,121,0.9463
skel-pal.bin,182,43,24,19,459,120,142,0.9198
skeleton.bin,195,43,24,19,431,111,140,0.9199
SkelPlus.bin,208,50,32,18,446,110,143,0.9203
SkelPPAL.bin,215,50,32,18,473,123,140,0.9265
Ski Hunt.bin,231,76,53,23,310,91,149,0.9298
Ski Run.bin,204,49,46,3,305,113,142,0.9426
Skiing (1).bin,91,22,18,4,202,46,137,0.9399
Skiing (2).bin,182,44,36,8,404,92,137,0.9399
Skiing (32 in 1) (PAL).bin,91,22,18,4,200,46,135,0.9408
Sky Diver (32 in 1) (PAL).bin,117,51,33,18,160,38,128,0.9453
Sky Diver.bin,116,51,33,18,156,39,130,0.9459
Sky Jinks (4k version).bin,234,64,40,24,398,94,137,0.9431
Sky Patrol (Prototype).bin,321,128,84,44,571,205,151,0.9308
Sky Skipper.bin,245,97,87,10,332,108,135,0.9316
Slot Machine (32 in 1) (PAL).bin,101,40,28,12,226,58,120,0.9503
Slot Machine.bin,101,40,28,12,224,58,121,0.9509
Slot Racers (32 in 1) (PAL).bin,91,99,75,24,161,64,123,0.9299
Slot Racers - Maze (1).bin,93,97,74,23,160,65,123,0.9298
Slot Racers - Maze (2).bin,186,194,148,46,320,130,123,0.9298
SMRFSAVE.BIN,611,149,119,30,668,273,144,0.9362
Smurfs - Rescue in Gargamel's Castle.bin,501,160,137,23,743,139,148,0.9332
Snail Against Squirrel (CCE).bin,177,148,91,57,382,130,143,0.9330
Sneek n Peek.bin,227,94,60,34,391,111,146,0.9401
Snoopy and the Red Baron.bin,493,215,155,60,704,186,149,0.9391
snow_wht.bin,423,178,125,53,536,218,145,0.9140
snthcart.bin,200,127,124,3,439,182,149,0.8993
Soccer (Unlicensed).bin,216,97,91,6,261,126,135,0.9325
Solar Fox.bin,404,205,201,4,541,295,148,0.9449
Solar Storm.bin,264,88,66,22,369,84,150,0.9413
Solaris.bin,722,214,116,98,1122,416,151,0.9326
SolarPlexus.bin,241,109,87,22,235,131,139,0.9400
Sorcerer's Apprentice.bin,391,177,155,22,514,241,150,0.9397
Sorcerer.bin,176,98,82,16,347,113,142,0.9250
SP-DL.BIN,491,135,105,30,373,89,142,0.9679
Space Attack.bin,197,85,59,26,296,168,139,0.9405
Space Canyon.bin,175,70,49,21,344,72,140,0.9489
Space Cavern.bin,174,71,49,22,361,72,142,0.9490
Space Invaders.bin,193,49,45,4,394,99,140,0.9428
Space Jockey (32 in 1) (PAL).bin,106,36,28,8,177,40,136,0.9409
Space Jockey (4K version).bin,212,60,50,10,362,82,137,0.9366
Space Jockey.bin,106,30,25,5,181,41,137,0.9366
Space Raid.bin,319,58,54,4,292,94,137,0.9417
Space Robot.bin,129,126,90,36,373,95,145,0.9446
Space Shuttle.bin,432,116,93,23,737,143,151,0.9252
Space Tunnel (PAL).bin,219,97,86,11,797,93,141,0.9479
Space Tunnel (Taiwan).bin,183,84,75,9,755,66,137,0.9412
Space War (32 in 1) (PAL).bin,84,62,53,9,217,34,126,0.9359
Space War (4k Version).bin,166,124,106,18,428,66,126,0.9359
Space War.bin,83,62,53,9,214,33,126,0.9359
SpaceAdventure_Zellers.BIN,245,112,95,17,364,54,144,0.9494
Spacechase.bin,160,70,61,9,400,107,135,0.9271
SpaceMaster X-7.bin,204,84,66,18,339,60,132,0.9489
Spider Fighter (16k Version).bin,1020,324,256,68,1304,256,145,0.9371
Spider Fighter.bin,255,81,64,17,326,64,145,0.9371
Spider-Man.bin,193,67,38,29,399,90,146,0.9443
Spiderdroid.bin,299,176,172,4,332,121,135,0.9448
spidermz.BIN,173,86,76,10,307,126,140,0.9429
Spike's Peak.bin,497,93,89,4,666,171,143,0.9451
Spitfire Attack.bin,227,122,98,24,464,109,134,0.9506
Springer.bin,104,135,111,24,678,470,149,0.9343
Sprintmaster.bin,273,184,138,46,826,242,151,0.9391
Spy Hunter.bin,296,94,51,43,789,141,151,0.9384
Squeeze Box.bin,188,63,60,3,364,108,143,0.9299
Squoosh.bin,109,39,30,9,128,32,111,0.9737
Sssnake.bin,189,39,37,2,359,132,135,0.9494
Stampede (1).bin,147,37,20,17,177,40,134,0.9427
Stampede (2).bin,294,74,40,34,354,80,134,0.9427
Stampede (32 in 1) (PAL).bin,147,37,20,17,177,40,134,0.9426
Star Fox.bin,232,103,89,14,410,117,141,0.9418
Star Raiders.bin,240,75,47,28,520,98,146,0.9567
Star Ship - Outer Space (1).bin,68,53,37,16,203,34,123,0.9403
Star Ship - Outer Space (2).bin,136,106,74,32,406,68,123,0.9403
Star Strike.bin,199,109,77,32,334,137,146,0.9446
Star Trek - Strategic Operations Simulator.bin,264,133,96,37,857,192,151,0.9364
Star Voyager.bin,172,139,124,15,409,88,137,0.9405
Star Wars - Death Star Battle.bin,376,228,210,18,716,260,150,0.9395
Star Wars - Empire Strikes Back.bin,160,60,51,9,401,123,145,0.9420
Star Wars - Jedi Arena.bin,281,103,73,30,294,86,140,0.9364
Star Wars - The Arcade Game.bin,240,120,102,18,758,193,151,0.9408
STAREMPR.BIN,160,60,51,9,401,123,145,0.9420
Stargate (1).bin,490,290,256,34,1570,288,151,0.9436
STARGN.BIN,276,109,72,37,394,115,138,0.9418
Starmaster.bin,180,73,66,7,311,82,146,0.9377
Starpath - Communist Mutants From Space.bin,351,127,85,42,541,179,149,0.9559
Starpath - Dragonstomper.bin,563,305,251,54,1335,549,151,0.9494
Starpath - Escape from the Mindmaster.bin,905,249,191,58,1322,460,151,0.9658
Starpath - Fireball.bin,243,73,55,18,411,172,146,0.9552
Starpath - Frogger (Official version by Sega).bin,405,116,73,43,389,168,150,0.9501
Starpath - Killer Satellites.bin,385,124,104,20,616,135,151,0.9302
Starpath - Party Mix.bin,945,222,179,43,1207,270,151,0.9537
Starpath - Phaser Patrol.bin,282,106,92,14,580,132,149,0.9562
Starpath - Rabbit Transit.bin,560,120,79,41,414,180,148,0.9540
Starpath - Suicide Mission.bin,199,133,106,27,339,193,148,0.9673
Starpath - Survival Island.bin,1224,360,285,75,1325,434,151,0.9584
Starpath - Sweat! - The Decathalon Game.bin,556,96,82,14,611,241,145,0.9769
Starpath - Sword Of Saros.bin,340,177,104,73,595,194,146,0.9542
STARTREK.BIN,264,133,96,37,857,192,151,0.9364
STARVYGR.BIN,172,139,124,15,409,88,137,0.9405
Steeplechase (1).bin,86,53,49,4,191,35,128,0.9363
Steeplechase (2).bin,172,106,98,8,382,70,128,0.9363
Stell-A-Sketch.bin,214,120,91,29,313,73,140,0.8451
Stellar Track.bin,93,130,125,5,328,157,141,0.9400
Stntman.bin,127,32,18,14,359,151,144,0.9352
Strategy X.bin,145,134,107,27,430,180,147,0.9448
StratOGemsDeluxe.bin,782,222,177,45,610,386,148,0.9742
Strawberry Shortcake Musical Match-Ups.bin,223,93,72,21,205,64,146,0.9203
Street Racer - Speedway II (2).bin,214,268,220,48,392,66,127,0.9475
Stronghold.bin,215,73,56,17,396,81,144,0.9415
stunt.bin,105,54,41,13,157,23,118,0.9454
Sub Scan.bin,271,93,73,20,311,166,144,0.9414
Submarine Commander.bin,252,125,108,17,454,106,140,0.9421
Subterrenea.bin,223,132,101,31,702,226,150,0.9346
Summer Games.bin,1035,205,160,45,1066,384,151,0.9183
Super Baseball.bin,442,175,142,33,859,325,151,0.9573
Super Box (CCE).bin,757,290,221,69,600,232,149,0.8848
Super Breakout.bin,129,35,30,5,401,73,138,0.9467
Super Challenge Baseball.bin,190,53,31,22,375,103,145,0.9432
Super Challenge Football.bin,308,72,50,22,328,105,143,0.9459
Super Cobra.bin,394,160,117,43,558,172,147,0.9146
Super Ferrari.bin,279,79,46,33,288,72,146,0.9478
Super Futebol.bin,268,147,138,9,424,225,146,0.9499
Superman (1).bin,160,114,62,52,408,114,141,0.9419
Suprman2.bin,160,114,62,52,407,115,144,0.9431
Surf's Up.bin,369,279,168,111,448,118,150,0.9235
Surfer's Paradise - But Danger Below!.bin,169,81,58,23,406,111,145,0.9440
Surround (32 in 1) (PAL).bin,92,28,17,11,179,63,116,0.9426
Surround (4k version).bin,182,56,34,22,358,126,118,0.9437
Survival Run.bin,210,120,92,28,286,106,146,0.9340
SWARCADE.BIN,240,120,102,18,758,193,151,0.9408
Swoops! (v0.96) (PAL).bin,270,74,64,10,345,77,147,0.9347
Swoops! (v0.96).bin,271,74,64,10,346,73,145,0.9349
SwordQuest - Earthworld.bin,414,150,125,25,437,268,150,0.9226
SwordQuest - Fireworld.bin,445,252,203,49,525,298,145,0.9443
SwordQuest - Waterworld.bin,429,180,131,49,431,212,151,0.9390
T.F. Space Invaders.bin,196,48,44,4,392,98,141,0.9431
Tacscan.bin,242,65,47,18,436,96,147,0.9411
Tanks But No Tanks.bin,161,65,57,8,457,156,143,0.9469
Tapeworm.bin,162,36,32,4,317,70,132,0.9343
Tapper.bin,650,160,86,74,663,150,150,0.9327
Targ (CBS).bin,150,49,45,4,294,51,137,0.9595
Task Force.bin,175,107,99,8,311,120,138,0.9462
Tax Avoiders.bin,377,200,176,24,459,251,150,0.9337
Taz.bin,217,215,158,57,449,298,150,0.9430
Teddy Apple.bin,286,69,40,29,312,75,139,0.9334
telepathy.bin,308,105,91,14,645,175,151,0.9296
tempst26.bin,262,53,39,14,668,176,145,0.9548
Tennis (1).bin,117,55,33,22,202,33,135,0.9468
Tennis (2).bin,234,110,66,44,404,66,135,0.9468
Tennis (32 in 1) (PAL).bin,117,55,33,22,200,34,133,0.9475
Test.bin,20,6,4,2,11,6,40,0.3022
testcart.bin,144,49,45,4,167,603,127,0.9276
Tetris 2600.bin,252,25,16,9,184,31,114,0.9220
Texas Chainsaw Massacre.bin,271,40,20,20,322,72,143,0.9468
This Planet Sucks.bin,328,120,106,14,239,136,140,0.9422
Threshhold.bin,202,99,89,10,381,120,143,0.9327
Thrust+.bin,352,317,226,91,887,398,151,0.9029
Thrust.bin,352,317,226,91,887,398,151,0.9029
Thunderground.bin,185,59,52,7,380,110,137,0.9386
Time Machine.bin,160,78,59,19,332,174,143,0.9470
Time Pilot (1).bin,370,151,108,43,450,118,148,0.9474
Time Race.bin,119,44,36,8,324,60,147,0.9391
Time Warp.bin,200,169,156,13,369,131,139,0.9431
Title Match Pro Wrestling (1).bin,448,128,103,25,596,169,149,0.9420
Tom Boy.bin,245,79,61,18,307,60,142,0.9401
Tomarc the Barbarian.bin,439,136,121,15,747,339,144,0.9406
Tooth Protectors.bin,478,189,162,27,486,234,147,0.9387
Towering Inferno.bin,261,163,88,75,319,117,140,0.9446
Tps.bin,328,120,106,14,239,136,140,0.9422
Track and Field.bin,1046,407,290,117,1229,540,150,0.9360
Traffic.bin,220,78,62,16,313,151,149,0.9452
Treasure Below (Video Gems, Thomas Jentzsch) (NTSC).bin,231,65,51,14,358,121,144,0.9489
treat.bin,261,106,87,19,235,116,141,0.9386
treat_ntsc.bin,227,101,79,22,262,143,136,0.9368
Trick Shot.bin,229,55,36,19,293,113,144,0.9346
Tron - Deadly Discs.bin,236,44,38,6,352,122,144,0.9470
Tuby Bird.bin,296,82,76,6,408,113,139,0.9470
Tunlrunr.bin,576,195,107,88,864,222,151,0.9036
Turmoil.bin,258,85,65,20,354,67,143,0.9420
Tutankham.bin,249,114,76,38,657,206,151,0.9341
UFO Patrol.bin,244,89,72,17,347,121,144,0.9392
Universal Chaos (PAL).bin,160,97,88,9,379,69,140,0.9525
UniversalProto.Bin,494,141,89,52,639,188,148,0.9450
UnknownActivision1_NTSC.bin,181,69,37,32,104,40,134,0.8585
UnknownActivision2_NTSC.bin,261,161,123,38,413,100,135,0.9461
Up n Down.bin,223,90,68,22,677,96,147,0.9343
Vanguard.bin,372,148,91,57,983,188,147,0.9453
VaultAssault.bin,233,116,107,9,258,95,134,0.9086
VenetianBlinds_NTSC.bin,76,24,22,2,52,12,101,0.7060
Venture.bin,135,65,46,19,357,75,148,0.9336
Vg_survi.bin,217,103,90,13,334,79,139,0.9499
Video Checkers.bin,157,116,105,11,394,159,141,0.9431
Video Chess.bin,97,74,67,7,454,114,144,0.9435
Video Cube (CCE).bin,288,109,83,26,295,98,139,0.9401
Video Jogger.bin,232,53,44,9,347,96,133,0.9341
Video Olympics - Pong Sports (1).bin,75,77,57,20,207,47,135,0.9451
Video Olympics - Pong Sports (2).bin,150,154,114,40,414,94,135,0.9451
Video Pinball.bin,193,106,97,9,375,74,138,0.9376
Video Reflex.bin,252,134,129,5,258,133,132,0.9442
Video Time Machine.bin,108,95,86,9,133,40,145,0.8776
Vidpin.bin,193,106,97,9,375,74,138,0.9376
VultureAttack_KTel.bin,319,86,83,3,276,68,142,0.9431
Wabbit.bin,436,114,104,10,295,76,136,0.9402
Walker.bin,199,104,84,20,209,162,145,0.9250
Wall Ball.bin,230,143,107,36,307,115,142,0.9385
Wall Defender.bin,141,115,109,6,374,96,144,0.9354
Warlords.bin,226,83,75,8,458,151,130,0.9344
Warplock.bin,128,110,85,25,616,60,140,0.9230
warworm.bin,252,55,33,22,333,146,137,0.9435
Weltraum Tunnel.bin,200,98,69,29,416,84,149,0.9426
Wing War.bin,267,151,96,55,733,167,150,0.9380
Wings_6-3-83.bin,731,88,67,21,740,197,151,0.9068
Winter Games.bin,789,228,133,95,1124,395,151,0.9394
Wizard of Wor.bin,233,85,68,17,473,80,141,0.9423
Wizard.bin,112,48,26,22,218,56,129,0.9436
Word Zapper.bin,134,68,51,17,286,99,147,0.9289
words.bin,162,72,67,5,241,87,143,0.9522
World End.bin,219,90,74,16,283,143,139,0.9448
Worm War I.bin,214,65,51,14,324,64,132,0.9462
X-Doom.bin,320,59,56,3,296,91,138,0.9409
X-Man (1).bin,245,110,90,20,302,178,143,0.9341
Xenophob.bin,513,368,311,57,1242,418,151,0.9402
Xevious.bin,199,85,64,21,287,131,147,0.9597
Yahtzee.bin,188,89,69,20,241,76,138,0.8896
Yar's Revenge (1).bin,228,156,79,77,436,100,141,0.9467
Z-Tack.bin,151,62,37,25,294,130,143,0.9346
Zaxxon.bin,318,158,110,48,642,172,141,0.9370
Zoo Fun.bin,176,75,59,16,317,91,142,0.9269
2Pak Black - Challenge - Surfing.bin,512,211,164,47,800,332,151,0.8699
2Pak Green - Hoppy - Alien Force.bin,634,193,136,57,860,255,151,0.8726
2Pak Yellow - Star Warrior - Frogger.bin,430,119,97,22,857,281,151,0.8684
32-in-1 (PAL).bin,3453,1702,1267,435,5928,1495,151,0.9417
3D Tic-Tac-Toe (1).bin,89,97,90,7,199,70,121,0.9341
3D Tic-Tac-Toe (2).bin,178,194,180,14,398,140,121,0.9341
3D Tic-Tac-Toe (32 in 1) (PAL).bin,89,97,90,7,199,71,121,0.9341
A Misterious Thief (CCE).bin,347,101,93,8,367,74,145,0.9360
A-Team.bin,314,253,216,37,583,110,151,0.9397
Acid Drop.bin,1176,514,238,276,966,566,143,0.9521
Action Man.bin,400,95,91,4,370,140,141,0.9386
Adventure.bin,156,81,38,43,345,152,140,0.9271
Adventures of Tron.bin,214,49,43,6,360,111,141,0.9484
AdventuresOnGX12.BIN,216,49,43,6,359,113,141,0.9489
Air Raid.bin,169,51,28,23,266,127,141,0.9239
Air Raiders.bin,245,31,24,7,361,98,139,0.9431
Air-Sea Battle (1).bin,100,106,82,24,212,32,125,0.9412
Air-Sea Battle (2).bin,200,212,164,48,424,64,125,0.9412
Air-Sea Battle (32 in 1) (PAL).bin,102,104,80,24,211,32,129,0.9412
Airlock.bin,321,59,54,5,305,59,129,0.9413
Alien's Return.bin,123,104,87,17,566,179,141,0.9385
Alien.bin,188,93,75,18,359,68,148,0.9370
AlligatorPeople.bin,213,82,63,19,309,80,140,0.9403
Alpha Beam with Ernie.bin,488,106,62,44,533,258,151,0.9274
Amidar.bin,299,176,172,4,331,120,135,0.9444
Angling.bin,160,62,48,14,164,28,129,0.9438
Apples and Dolls (CCE).bin,232,64,42,22,288,74,143,0.9206
Aquaventure.bin,414,131,74,57,575,172,150,0.9390
Armor Ambush.bin,139,81,57,24,247,109,139,0.9324
Artillery Duel (1).bin,389,251,197,54,643,152,146,0.9311
Assault.bin,175,99,75,24,348,132,146,0.9377
Asterix.bin,202,222,163,59,455,339,150,0.9462
ASTEROID.BIN,222,140,97,43,629,189,150,0.9543
Asteroids.bin,272,145,100,45,685,202,150,0.9323
ASTRBLST.BIN,141,46,34,12,321,163,136,0.9457
Astro War.bin,239,31,28,3,319,107,141,0.9567
Astroblast.bin,141,46,34,12,321,163,136,0.9457
Astrowar.bin,239,31,28,3,319,107,141,0.9567
Atari Video Cube.bin,288,111,85,26,303,92,140,0.9398
Atlantis (Activision) (1).bin,301,36,27,9,358,74,142,0.9391
Atlantis2.BIN,305,38,26,12,361,78,140,0.9384
Autorennen (Grand Prix).bin,305,62,57,5,292,65,135,0.9357
Bachellorette Party.bin,239,76,52,24,265,92,137,0.9542
Bachelor.bin,240,75,52,23,263,92,138,0.9528
backfire.bin,464,117,104,13,262,87,133,0.9449
Backgammon.bin,126,99,72,27,410,186,136,0.9432
Bank Heist.bin,202,103,84,19,313,132,142,0.9385
Barnstorming.bin,249,71,63,8,284,95,137,0.9396
Base Attack (PAL).bin,148,61,38,23,300,125,143,0.9326
Basic Programming.bin,119,69,61,8,304,182,142,0.9420
Basketball (32 in 1) (PAL).bin,79,45,41,4,224,14,128,0.9146
Basketball (4k version).bin,158,90,82,8,448,28,128,0.9445
Battlezone.bin,556,95,89,6,626,209,149,0.9381
Beamrider (2).bin,488,144,113,31,754,189,149,0.9401
Beany Bopper.bin,203,132,89,43,289,61,142,0.9391
Beat 'Em and Eat 'Em.bin,263,89,80,9,275,118,134,0.9341
Berenstain Bears (Coleco).bin,475,174,140,34,591,136,150,0.9348
Bermuda Triangle.bin,217,80,51,29,365,63,144,0.9429
Bermuda.bin,199,56,49,7,382,89,144,0.9364
Berzerk.bin,214,63,45,18,277,182,138,0.9464
berzerkvoice.bin,416,160,117,43,358,232,151,0.9129
Bi! Bi! (PAL).bin,163,142,104,38,358,125,142,0.9482
Big Bird's Egg Catch.bin,645,146,116,30,541,205,150,0.9408
Bionic Breakthrough.bin,244,126,107,19,697,183,149,0.9417
Blackjack (1).bin,81,43,32,11,202,47,135,0.9392
Blackjack (2).bin,162,86,64,22,404,94,135,0.9392
Blackjack (32 in 1) (PAL).bin,81,43,32,11,202,47,135,0.9391
BloodyHumanFreeway_NTSC.bin,175,63,38,25,135,45,126,0.9476
Blueprint.bin,415,88,68,20,685,188,144,0.9358
BMX Airmaster.bin,869,478,356,122,1183,467,151,0.9319
Bobby is Going Home (CCE).bin,276,131,79,52,236,80,143,0.9311
Bogey Blaster.bin,245,31,24,7,361,98,139,0.9432
Boggle.bin,97,95,72,23,159,67,121,0.9158
Boom Bang.bin,363,100,75,25,304,74,146,0.9378
Bowling (1).bin,99,50,45,5,192,36,129,0.9429
Bowling (2).bin,98,50,45,5,192,36,129,0.9426
Bowling (32 in 1) (PAL).bin,99,50,45,5,192,37,129,0.9429
Bowling (4k version).bin,198,100,90,10,384,72,129,0.9429
Boxing (1).bin,96,42,28,14,186,45,135,0.9421
Boxing (2).bin,192,84,56,28,372,90,135,0.9421
Boxing (32 in 1) (PAL).bin,96,42,28,14,184,45,133,0.9432
Brain Games (1).bin,61,32,22,10,165,61,130,0.9346
Brain Games (2).bin,122,64,44,20,330,122,130,0.9346
Breakdown.bin,141,115,109,6,374,95,144,0.9354
Breakout - Breakaway IV (1).bin,91,33,30,3,179,58,128,0.9390
Breakout - Breakaway IV (2).bin,182,66,60,6,358,116,128,0.9390
Brick Kick.bin,194,68,60,8,361,103,146,0.9398
Bridge.bin,79,132,119,13,495,113,142,0.9460
Buck Rogers - Planet of Zoom.bin,407,178,143,35,607,179,149,0.9403
Bugs Bunny.bin,261,84,61,23,508,162,150,0.9321
Bugs.bin,209,54,39,15,297,131,130,0.9481
Bumpnjump.bin,398,86,74,12,524,192,149,0.8343
Burgertime.bin,453,106,95,11,778,322,151,0.9318
Burning Desire.bin,175,81,66,15,386,91,146,0.9357
Cakewalk.bin,345,63,52,11,301,139,144,0.9358
California Games.bin,732,202,163,39,1263,395,151,0.9369
Canyon Bomber (4k version).bin,270,142,116,26,300,82,132,0.9485
Carnival.bin,219,78,64,14,377,67,146,0.9408
Casino.bin,141,94,76,18,362,93,144,0.9375
Cat Trax.bin,251,98,77,21,327,154,140,0.9454
Cathouse Blues.bin,237,127,93,34,306,123,140,0.9296
Catmouse.bin,251,98,77,21,327,154,140,0.9454
Centipede.bin,517,160,98,62,621,183,149,0.9430
Challenge (Alt).bin,388,173,132,41,694,293,149,0.9435
Challenge of...NEXAR.bin,165,53,46,7,347,69,139,0.9572
Chase the Chuckwagon.bin,258,133,125,8,214,124,142,0.9313
Checkers (32 in 1) (PAL).bin,88,52,46,6,179,101,125,0.9485
Checkers (Activision).bin,88,52,46,6,181,101,129,0.9475
China Syndrome.bin,183,94,79,15,277,86,141,0.9385
Chopper Command (CCE).bin,255,76,58,18,403,83,147,0.9438
Chuck Norris Superkicks.bin,274,123,94,29,673,201,149,0.9385
Chuckick.bin,274,123,94,29,673,201,149,0.9385
Chuckwgn.bin,258,133,125,8,214,124,142,0.9313
Circus Atari.bin,148,33,31,2,264,65,145,0.9620
Circus-j.bin,151,34,32,2,273,76,145,0.9603
climber5_NTSC.bin,241,74,69,5,343,78,145,0.9343
Clown Downtown (PAL).bin,199,104,84,20,209,162,145,0.9250
Coconuts.bin,220,79,66,13,368,103,143,0.9273
Code Breaker (1).bin,105,134,101,33,178,38,132,0.9463
Code Breaker (2).bin,210,268,202,66,356,76,132,0.9463
Coke Wins.bin,229,50,45,5,317,104,139,0.9409
Coln.bin,123,104,87,17,565,179,141,0.9393
Color Bar Generator.bin,312,115,87,28,176,106,149,0.9138
Colors Demo.bin,18,8,6,2,8,1,29,0.2782
Combat (32 in 1) (PAL).bin,101,51,32,19,176,52,138,0.9342
Combat - Tank Plus (4k Version).bin,194,102,64,38,350,108,135,0.9340
combat2.bin,346,32,24,8,465,241,147,0.9533
Commando Raid.bin,252,99,94,5,362,91,140,0.9417
Commando.bin,752,356,334,22,653,416,148,0.9288
Concentration.bin,71,19,16,3,175,23,127,0.9365
Condor Attack.bin,319,86,83,3,276,68,142,0.9431
CONDOR.BIN,319,86,83,3,276,68,142,0.9431
confrontation.bin,225,136,99,37,411,126,141,0.9394
Congbong.bin,543,117,102,15,793,180,149,0.9402
Congo Bongo.bin,543,117,102,15,793,180,149,0.9402
Conquest of Mars.bin,799,229,193,36,1459,491,151,0.9406
Cookie Monster Munch.bin,409,199,167,32,551,151,150,0.9329
Corrida da Matematica (CCE).bin,111,106,86,20,408,116,138,0.9394
Cosmic Ark (CCE).bin,218,59,54,5,409,100,141,0.9500
Cosmic Commuter.bin,299,63,54,9,387,77,148,0.9423
Cosmic Corridor.bin,192,91,81,10,818,114,140,0.9541
Cosmic Creeps.bin,174,66,24,42,234,129,140,0.9432
Cosmic Swarm (32 in 1) (PAL).bin,105,21,16,5,181,46,119,0.9293
Cosmic Swarm (4k Version).bin,206,42,32,10,362,92,119,0.9293
Cosmic Swarm.bin,103,21,16,5,181,46,119,0.9293
Cracked.BIN,1046,260,207,53,819,266,151,0.9306
Crackpots.bin,361,98,74,24,322,76,147,0.9395
Crash Dive.bin,227,100,70,30,369,100,150,0.9398
Crazy Climber.bin,413,173,134,39,646,217,150,0.9355
crazyballoon-ntsc.bin,145,52,44,8,395,55,143,0.9205
CrazyValet.bin,184,45,41,4,247,56,122,0.9122
Criminal Pursuit.bin,347,101,93,8,367,68,144,0.9370
Cross Force.bin,173,67,52,15,320,135,141,0.9413
Crossbow.bin,1257,271,220,51,1412,426,151,0.9364
Cruise Missile.bin,268,60,54,6,350,106,130,0.9506
Crusmisl.bin,268,60,54,6,350,106,130,0.9506
Crypts of Chaos.bin,134,35,32,3,365,77,145,0.9308
Crystal Castles.bin,288,188,140,48,954,381,151,0.9379
Cubicolor.bin,392,96,70,26,345,104,136,0.9452
Cubo Magico (CCE).bin,391,93,70,23,343,106,135,0.9449
Custerev.bin,162,43,36,7,1122,99,134,0.9562
Dancing Plate (PAL).bin,214,110,87,23,452,116,141,0.9390
Darkcham.bin,504,273,252,21,1279,271,151,0.9145
Darkcvrn.bin,200,79,38,41,321,123,143,0.9391
darkmage.bin,161,79,71,8,247,170,128,0.9155
Deadly Duck.bin,337,71,50,21,275,69,138,0.9460
Death Trap.bin,317,108,81,27,307,161,143,0.9415
Decathlon.bin,456,132,107,25,778,117,149,0.9418
Defender 2 (16K version).bin,490,288,254,34,1604,288,151,0.9424
Defender 2.bin,245,144,127,17,802,144,151,0.9423
Defender.bin,155,90,55,35,398,94,141,0.9438
Demolition Herby.bin,156,63,58,5,288,95,137,0.9358
Demon Attack (Activision).bin,176,76,41,35,414,111,145,0.9428
Demons to Diamonds.bin,183,53,43,10,389,75,145,0.9449
Desert Falcon.bin,355,211,163,48,1342,290,151,0.9343
Dethstar.bin,376,228,210,18,716,260,150,0.9395
Dice Puzzle.bin,155,91,76,15,299,153,141,0.9491
Dig Dug.bin,629,261,183,78,1748,410,151,0.9355
Dishastr.bin,195,90,71,19,289,100,143,0.9290
Dodge Em.bin,203,145,113,32,431,201,140,0.9467
Dolphin.bin,302,82,77,5,424,105,143,0.9459
Donald Duck's Speedboat.bin,276,119,108,11,473,94,148,0.9345
Donkey Kong Jr. (CCE).bin,651,78,58,20,696,204,147,0.9411
Donkey Kong.bin,180,79,56,23,344,57,145,0.9461
Double Dragon.bin,488,251,189,62,1272,378,151,0.9290
Double Dunk.bin,857,416,348,68,1376,415,151,0.9406
Dragon Defender.bin,189,106,81,25,380,106,138,0.9440
Dragonfire.bin,209,88,61,27,389,69,143,0.9399
Dragster (1).bin,123,39,33,6,149,35,138,0.9445
Dragster (2).bin,246,78,66,12,298,70,138,0.9445
Drgndfnd.bin,189,106,81,25,380,106,138,0.9440
Dschungle Boy (Pitfall).bin,245,79,61,18,307,59,142,0.9401
Duck Shoot (PAL).bin,230,38,31,7,378,146,144,0.9414
Dukes of Hazzard.bin,444,365,229,136,842,343,151,0.9366
dukes_v2.bin,174,156,108,48,314,60,119,0.9375
Dumbo's Flying Circus.bin,199,120,94,26,560,211,151,0.9281
dune.bin,174,69,53,16,299,83,147,0.9567
E.T..bin,267,252,199,53,702,163,150,0.9328
Earth Dies Screaming.bin,247,69,45,24,318,53,147,0.9437
Eggomania.bin,139,66,28,38,307,105,142,0.9311
ElevatorAction.bin,362,154,129,25,718,109,149,0.9519
Eliladdr.bin,374,76,66,10,255,77,143,0.9398
Elk Attack.bin,293,112,96,16,390,149,150,0.9408
Encounter at L5.bin,187,84,82,2,268,51,140,0.9382
Enduro.bin,277,88,55,33,287,72,144,0.9437
Entity.BIN,259,94,75,19,318,83,143,0.9398
Entombed.bin,172,72,67,5,367,125,131,0.9509
Espial.bin,42,141,100,41,444,193,148,0.8842
Euchre.bin,235,88,79,9,360,119,141,0.9412
EuchrePAL.bin,235,89,79,10,363,119,141,0.9418
Ewok Adventure (Parker Bros, Thomas Jentzsch) (NTSC).bin,297,107,89,18,772,270,151,0.9349
Ewokadvn.bin,300,107,89,18,776,265,151,0.9336
Exocet.bin,263,60,54,6,342,101,127,0.9516
F-14 Tomcat Flight Simulator.bin,734,203,174,29,1533,351,151,0.9363
falldown_ntsc.bin,280,93,77,16,395,211,146,0.9029
Fantastic Voyage.bin,213,51,45,6,458,56,130,0.9482
Farmyard Fun.bin,299,53,49,4,281,133,140,0.9365
Fast Eddie.bin,227,56,48,8,299,50,139,0.9398
Fast Food.bin,148,65,52,13,298,143,139,0.9271
Fatal Run.bin,1223,504,376,128,1844,1033,151,0.9405
Fathom.bin,306,182,154,28,789,183,150,0.9438
Fighterp.bin,734,203,174,29,1533,351,151,0.9363
Final Approach.bin,308,70,50,20,358,101,143,0.9485
Fire Birds.bin,176,99,79,20,349,128,146,0.9375
Fire Fighter.bin,285,90,82,8,422,80,139,0.9360
Fire Fly.bin,179,103,89,14,373,175,140,0.9406
Fire Spinner.bin,354,93,62,31,327,88,147,0.9406
Fishing Derby (16k Version).bin,1280,496,384,112,1336,232,132,0.9430
Fishing Derby (32 in 1) (PAL).bin,160,62,48,14,164,28,130,0.9438
Fishing Derby (pirate) (32 in 1) (PAL).bin,160,64,50,14,166,26,130,0.9434
Flag Capture (32 in 1) (PAL).bin,74,73,38,35,184,68,125,0.9486
Flag Capture.bin,74,73,38,35,184,67,124,0.9485
FlapPing.bin,197,109,95,14,221,76,132,0.9128
Flash Gordon.bin,245,112,95,17,364,54,144,0.9494
Flashgrd.bin,245,112,95,17,364,54,144,0.9494
Football (1).bin,105,44,33,11,185,42,130,0.9319
Football (2).bin,210,88,66,22,370,84,130,0.9319
Football (32 in 1) (PAL).bin,105,44,33,11,185,42,131,0.9319
Foozball.bin,216,100,94,6,261,126,132,0.9324
Forest (PAL).bin,277,70,47,23,355,108,141,0.9384
fotr.bin,98,64,61,3,202,61,127,0.9060
Frankenstein's Monster.bin,316,113,83,30,374,97,140,0.9456
Freeway (1).bin,174,65,40,25,148,43,127,0.9503
Freeway (2).bin,348,130,80,50,296,86,127,0.9503
Freeway (32 in 1) (PAL).bin,174,65,40,25,146,43,124,0.9512
Freeway (pirate) (32 in 1) (PAL).bin,175,65,40,25,143,43,124,0.9492
Frogflys.bin,116,50,38,12,286,93,141,0.9211
Frogger II - Threedeep!.bin,301,65,59,6,662,313,147,0.9398
Frogger.bin,133,28,23,5,359,103,149,0.9379
Frogpond.bin,266,34,17,17,589,182,148,0.9608
Frontline.bin,276,135,96,39,610,213,151,0.9350
Frostbite.bin,283,83,71,12,340,69,146,0.9392
Fun with Numbers (32 in 1) (PAL).bin,75,56,39,17,179,64,127,0.9475
Fun With Numbers.bin,75,56,39,17,179,64,126,0.9474
G.I. Joe - Cobra Strike.bin,401,93,89,4,372,137,141,0.9379
Galaga.bin,200,62,53,9,367,67,144,0.9365
Galaxian.bin,676,302,289,13,716,132,147,0.9371
Game of Concentration.bin,71,19,16,3,175,23,127,0.9365
Gangster Alley.bin,175,106,96,10,299,114,144,0.9413
garfield.bin,251,164,139,25,340,249,151,0.8511
Gas Hog.bin,291,86,69,17,369,45,145,0.9464
Gauntlet.bin,214,128,75,53,360,69,141,0.9391
Ghost Manor (1).bin,187,63,57,6,254,78,146,0.9247
Ghost Manor (2).bin,297,125,114,11,553,261,149,0.9393
Ghostbusters II.bin,543,257,224,33,790,217,149,0.9542
Ghostbusters.bin,510,122,81,41,738,164,149,0.9338
Ghostman.bin,297,125,114,11,553,261,149,0.9393
Gigolo.bin,236,127,93,34,314,125,139,0.9316
Glacier Patrol.bin,152,73,65,8,291,59,140,0.9457
Glib.bin,221,54,31,23,292,194,146,0.9351
GoFish_NTSC.bin,270,157,126,31,444,155,150,0.9141
Golf (1).bin,100,25,20,5,190,30,143,0.9429
Golf (2).bin,200,50,40,10,380,60,143,0.9429
Golf (32 in 1) (PAL).bin,100,23,19,4,189,30,143,0.9427
Golf.bin,100,25,20,5,190,30,143,0.9429
Gopher.bin,175,64,53,11,290,123,143,0.9314
Gorf.bin,265,131,94,37,399,120,136,0.9415
Grand Prix (16k Version).bin,1220,256,228,28,1192,244,138,0.9353
Gravitar.bin,324,170,159,11,733,179,150,0.9375
Great Escape.bin,160,78,59,19,332,174,143,0.9470
Gremlins.bin,378,196,142,54,549,215,150,0.9350
Grover's Music Maker.bin,328,133,105,28,354,176,148,0.9248
Guardian.bin,349,110,88,22,357,119,137,0.9464
GUNNTSC.bin,129,65,43,22,293,87,144,0.9169
Gyruss.bin,131,84,66,18,594,172,149,0.9110
H.E.R.O..bin,335,86,68,18,725,181,151,0.9270
Halloween.bin,189,62,35,27,361,103,139,0.9470
Hangman.bin,110,24,14,10,226,91,143,0.9124
Harbor Escape.bin,199,55,47,8,355,68,145,0.9374
Haunted House.bin,125,87,65,22,469,110,143,0.9404
Hole Hunter.bin,163,85,63,22,321,86,142,0.9360
Holey Moley.bin,353,65,41,24,341,107,146,0.9509
Home Run Baseball (1).bin,94,82,77,5,225,28,138,0.9413
Home Run Baseball (2).bin,188,164,154,10,450,56,138,0.9413
Homerun (32 in 1) (PAL).bin,94,82,77,5,225,28,138,0.9413
Human Cannonball (32 in 1) (PAL).bin,111,51,37,14,164,85,139,0.9390
Human Cannonball - Cannon Man (1).bin,110,51,37,14,164,84,138,0.9390
Human Cannonball - Cannon Man (2).bin,220,102,74,28,328,168,138,0.9390
I Want My Mommy.bin,232,64,42,22,297,74,141,0.9210
I.Q. 180.bin,270,87,78,9,219,140,138,0.9369
Ice Hockey.bin,227,90,71,19,403,76,142,0.9459
Ikari Warriors.bin,793,160,129,31,1138,253,149,0.9189
Imagic Selector.bin,439,73,60,13,231,84,137,0.9388
Immies and Aggies.bin,227,107,95,12,343,76,137,0.9424
IncaGold_Zellers.BIN,173,83,75,8,313,169,139,0.9466
Indy 500 (4k Version).bin,148,114,78,36,304,130,130,0.9376
Infiltrate.bin,130,40,29,11,278,60,143,0.9473
International Soccer.bin,216,100,94,6,261,127,132,0.9323
INV+.bin,228,119,90,29,267,77,141,0.9451
INV.bin,223,96,72,24,222,74,129,0.9128
Iq180.bin,270,87,78,9,219,140,138,0.9369
Ixion.bin,223,50,39,11,636,148,150,0.9471
James Bond 007.bin,536,176,59,117,668,224,148,0.9405
Jammed.bin,134,65,57,8,236,96,150,0.9161
Jawbreaker.bin,202,155,137,18,427,120,138,0.9408
Jediaren.bin,281,103,73,30,294,86,140,0.9364
Journey Escape.bin,200,125,92,33,397,93,140,0.9373
Joust.bin,336,175,120,55,819,153,150,0.9422
JoustPong.bin,203,103,95,8,196,69,132,0.9266
Jrpacman.bin,561,322,232,90,994,345,151,0.9203
Jungle Fever.bin,179,79,64,15,377,92,148,0.9387
Jungle Hunt.bin,517,165,135,30,838,130,149,0.9420
Kaboom! (1).bin,147,49,44,5,183,39,130,0.9415
Kaboom! (2).bin,294,98,88,10,366,78,130,0.9415
kamisauc.bin,246,54,47,7,346,105,127,0.9545
Kangaroo.bin,438,167,129,38,637,131,149,0.9360
Karate.bin,223,120,110,10,267,224,142,0.9344
Keystone Kapers.bin,256,78,39,39,343,74,145,0.9368
King Kong.bin,195,75,66,9,383,119,144,0.9456
Klax.bin,912,341,323,18,1763,465,151,0.9436
Knight on the Town.bin,223,91,67,24,361,91,144,0.9499
Kool Aid Man.bin,255,99,95,4,300,119,141,0.9417
Krull.bin,333,163,140,23,773,200,151,0.9405
Kung Fu Master.bin,367,169,141,28,764,263,150,0.9366
Kung Fu.bin,259,122,112,10,278,245,140,0.9406
labyrinth.bin,331,138,116,22,471,120,150,0.9534
Lady in Wading.bin,226,93,69,24,347,89,144,0.9494
Laser Blast (1).bin,159,48,34,14,175,27,121,0.9399
Laser Blast (2).bin,318,96,68,28,350,54,121,0.9399
Laser Blast (32 in 1) (PAL).bin,159,48,34,14,173,27,119,0.9409
Laser Gates.bin,202,98,69,29,411,83,149,0.9421
LASRGATE.BIN,202,98,69,29,411,83,149,0.9421
Lasrvoly.bin,200,98,69,29,416,83,149,0.9426
lochjaw.bin,214,35,24,11,439,63,146,0.9515
Lock n Chase.bin,202,41,33,8,369,108,142,0.9340
London Blitz.bin,376,126,115,11,360,138,145,0.9408
Looping.BIN,397,138,74,64,761,236,150,0.9351
LordOfTheRings.bin,399,179,160,19,792,253,149,0.9377
LOSTLUGG.BIN,272,67,36,31,336,126,140,0.9496
M.A.D..bin,172,131,71,60,347,107,146,0.9476
M.A.S.H..bin,200,83,72,11,314,60,146,0.9367
magicard.bin,73,69,62,7,170,87,140,0.9344
Malagai.bin,196,25,21,4,416,124,145,0.9385
Mangia.bin,264,96,79,17,280,98,141,0.9296
Marauder.bin,193,105,60,45,389,85,139,0.9409
Marine Wars.bin,143,54,26,28,417,143,145,0.9378
Marineflieger (PAL).bin,261,47,39,8,316,117,140,0.9495
MARIOBRO.BIN,401,171,152,19,496,244,150,0.9401
Master Builder.bin,148,50,44,6,352,159,143,0.9394
Masters of the Universe - The Power of He-Man.bin,670,256,211,45,888,302,150,0.9330
Math Gran Prix.bin,113,107,87,20,409,110,140,0.9402
Maze Craze.bin,229,22,18,4,325,133,132,0.9468
McDonalds.bin,145,72,51,21,395,143,143,0.9400
mc_ntsc_7_26_3.bin,1082,136,107,29,1051,393,151,0.9160
mc_pal_4_28_3.bin,1082,126,97,29,1066,428,151,0.9159
Mega Force.bin,147,82,52,30,406,65,150,0.9370
Megamania.bin,319,56,53,3,319,100,141,0.9403
Meltdown.bin,227,77,72,5,315,92,144,0.9386
Meteor Defence.bin,242,33,30,3,317,99,140,0.9554
Midnight Magic.bin,683,171,123,48,843,332,150,0.9330
Millipede.bin,632,259,240,19,1325,393,151,0.9474
MindMaze.bin,373,80,75,5,312,125,134,0.9622
Miner 2049er.bin,158,162,105,57,602,488,148,0.9388
Mines of Minos.bin,174,102,89,13,400,109,144,0.9418
Minesweeper.bin,167,85,80,5,132,32,125,0.8477
Miniature Golf (32 in 1) (PAL).bin,79,66,42,24,194,37,128,0.9397
Miniature Golf - Arcade Golf (1).bin,78,67,43,24,195,37,131,0.9406
Miniature Golf - Arcade Golf (2).bin,156,134,86,48,390,74,131,0.9406
MINRVOL2.BIN,152,98,87,11,647,445,148,0.9403
MIN_GOLF.BIN,78,67,43,24,195,37,131,0.9406
Missile Command.bin,135,133,96,37,373,93,145,0.9427
Missile Control.bin,233,102,67,35,288,131,140,0.9487
Mission 3000 A.D..bin,200,67,58,9,421,93,147,0.9460
Misspig.bin,206,79,65,14,350,109,130,0.9625
Mogul Maniac.bin,244,105,75,30,352,59,144,0.9349
MondoPong.bin,193,81,63,18,192,103,139,0.9082
Monstercise.bin,175,35,32,3,187,101,135,0.9392
Montezuma's Revenge.bin,363,130,108,22,768,255,150,0.9343
Moon Patrol.bin,500,287,250,37,621,197,151,0.9415
Moonsweeper.bin,272,172,84,88,609,164,149,0.9375
Moto Laser (CCE).bin,147,82,52,30,406,65,150,0.9370
Motocross Racer - Joystik.bin,430,201,171,30,655,233,148,0.9366
Motocross Racer.bin,429,202,172,30,687,233,148,0.9362
Motocross.bin,189,72,62,10,282,105,148,0.9435
Motorodeo.bin,619,318,252,66,967,527,151,0.9501
Mouse Trap.bin,144,36,28,8,350,104,141,0.9463
Mr. Do!'s Castle.bin,268,195,136,59,647,202,146,0.9340
Mr. Do!.bin,327,142,131,11,681,255,150,0.9357
Mr. Postman.bin,255,114,94,20,424,116,142,0.9378
Ms. Pac-Man.bin,353,163,135,28,695,147,150,0.9450
MTNKING.BIN,357,69,58,11,883,169,151,0.9187
Multi-Sprite Demo.bin,206,82,70,12,390,96,139,0.8518
Music Machine.bin,198,56,51,5,228,50,138,0.9186
My Golf.bin,341,186,154,32,470,186,151,0.9333
NAMEGAME.BIN,223,29,23,6,300,94,144,0.9299
Nexar.bin,165,53,46,7,347,69,139,0.9572
NGHTMARE.BIN,127,32,18,14,359,151,144,0.9352
Night Driver (4k Version).bin,252,224,168,56,382,72,129,0.9413
Night Stalker.bin,197,79,38,41,325,123,143,0.9399
Nightmare.bin,127,32,18,14,359,151,144,0.9352
No Escape! (1).bin,225,63,47,16,400,85,147,0.9429
Nuts.bin,164,74,53,21,196,67,136,0.9180
Obelix.bin,206,125,108,17,528,216,150,0.9456
Ocean City Defender.bin,302,39,28,11,353,74,144,0.9395
Octopus.bin,223,29,23,6,300,94,144,0.9299
Off Your Rocker.bin,225,98,83,15,347,102,134,0.9396
Ofthwall.bin,714,182,140,42,1446,330,151,0.9334
Oink!.bin,266,102,85,17,403,70,143,0.9401
Okie Dokie.bin,100,55,48,7,180,64,121,0.9489
Omegarac.bin,280,129,109,20,729,232,149,0.9327
Open Sesame.bin,245,52,48,4,411,122,141,0.9370
Oscar's Trash Race.bin,496,128,107,21,513,233,150,0.9393
Othello (32 in 1) (PAL).bin,100,27,24,3,226,61,136,0.9398
Out of Control.bin,190,91,53,38,354,112,145,0.9260
Outerspc.bin,68,53,37,16,203,34,123,0.9403
Outlaw (32 in 1) (PAL).bin,101,41,31,10,145,51,126,0.9436
Outlaw - GunSlinger (2).bin,202,82,62,20,290,102,126,0.9436
Oystron.bin,197,123,116,7,332,67,145,0.9379
Pac Kong.bin,173,83,75,8,313,169,139,0.9466
Pac-Man.bin,208,70,65,5,366,170,139,0.9391
Pac-Space.bin,208,70,65,5,366,170,140,0.9392
Panda Chase.bin,197,75,68,7,290,81,148,0.9290
Parachute.bin,212,105,84,21,300,129,149,0.9352
Peek-A-Boo.bin,177,71,68,3,312,107,145,0.9446
Pele's Championship Soccer (pirate).bin,171,75,51,24,432,101,145,0.9361
Pele's Championship Soccer.bin,174,74,50,24,434,100,143,0.9369
Pele.bin,174,74,50,24,434,100,143,0.9369
Pengo.bin,340,120,102,18,509,148,150,0.9423
Pete Rose Baseball.bin,676,418,306,112,1179,304,151,0.9459
Phantom Tank (PAL).bin,172,65,56,9,487,155,141,0.9482
phantompanzer.bin,172,65,56,9,487,155,141,0.9482
Pharoah's Curse.bin,189,39,25,14,299,179,137,0.9463
Philly Flasher.bin,254,91,81,10,526,115,136,0.9457
Phoenix.bin,415,205,174,31,766,105,147,0.9406
Pick 'n Pile.bin,925,248,223,25,975,697,147,0.9487
PickUp.BIN,248,69,54,15,317,88,147,0.9365
Picnic.bin,183,119,94,25,288,163,136,0.9441
Piece o' Cake.bin,330,110,64,46,318,130,137,0.9359
Pigs in Space.bin,331,108,98,10,674,175,151,0.9315
Pitfall II - Lost Caverns (10K version).bin,594,116,81,35,828,197,151,0.9174
Pitfall! No Walls Hack.bin,244,81,62,19,326,59,145,0.9373
Pitfall!.bin,244,81,62,19,326,59,143,0.9374
PizzaChef.bin,265,117,86,31,343,120,144,0.9325
Planet Patrol.bin,320,73,58,15,351,101,135,0.9476
PlanetOfTheApes.bin,130,42,27,15,321,72,137,0.9395
Plaque Attack.bin,231,73,64,9,338,97,146,0.9412
Pleiades.bin,612,165,125,40,686,224,148,0.9453
poker_squares.bin,370,51,41,10,231,31,137,0.9117
Polaris.bin,51,142,118,24,522,443,150,0.9380
Pole Position.bin,492,104,90,14,566,97,151,0.9355
Polo.bin,75,40,25,15,222,47,134,0.9425
Pompeii.bin,229,42,33,9,250,87,139,0.9357
Pooyan.bin,160,61,33,28,401,147,149,0.9380
Popeye.bin,333,144,112,32,607,186,151,0.9473
Porky's.bin,284,121,96,25,663,287,149,0.9359
pressgge.bin,109,61,50,11,99,32,92,0.8964
Pressure Cooker.bin,496,110,104,6,541,133,150,0.9409
Private Eye.bin,367,118,103,15,564,143,150,0.9385
Puzzle (Taiwan).bin,229,22,18,4,325,133,133,0.9468
Pyramid War.bin,250,78,58,20,405,76,146,0.9461
Q-bert's Qubes (2).bin,361,157,129,28,512,234,151,0.9326
Q-bert.bin,276,88,70,18,307,67,143,0.9385
qb215NTSC.bin,152,60,43,17,297,156,146,0.9360
qb215PAL.bin,154,60,43,17,299,155,145,0.9377
qb215STELLA.bin,152,60,43,17,297,156,146,0.9361
Quadrun.bin,359,176,148,28,482,209,151,0.9355
Quest for Quintana Roo.bin,423,56,52,4,548,250,151,0.9425
Quick Step!.bin,290,84,44,40,348,120,140,0.9439
Rabbittr.bin,573,116,86,30,458,285,148,0.9426
Racquetball.bin,427,107,82,25,313,66,144,0.9457
Radarlok.bin,617,220,177,43,1261,352,151,0.9194
Raft Rider.bin,264,129,109,20,278,65,136,0.9467
Raiders of the Lost Ark.bin,225,164,143,21,734,172,151,0.9351
Rainbow Invaders NTSC.bin,220,100,87,13,376,110,138,0.9448
Ram It.bin,264,42,37,5,399,112,135,0.9433
Rampage!.bin,496,186,138,48,1216,557,151,0.9261
Reactor.bin,156,87,64,23,419,71,140,0.9471
RealSports Baseball.bin,362,252,206,46,766,237,150,0.9462
RealSports Boxing.bin,757,290,221,69,600,231,149,0.8850
RealSports Football.bin,289,147,88,59,784,244,150,0.9354
RealSports Soccer.bin,269,148,139,9,425,219,146,0.9503
RealSports Tennis (1).bin,517,199,81,118,592,167,146,0.9312
RealSports Volleyball.bin,188,99,80,19,357,80,146,0.9448
Rescue Bira Bira.bin,178,83,67,16,377,97,144,0.9388
Rescue Terra I.bin,151,70,50,20,409,71,143,0.9418
Resgate Espacial (CCE).bin,272,169,84,85,609,166,149,0.9373
Revenge of the Beefsteak Tomatoes.bin,287,101,84,17,342,144,141,0.9463
RevengeOfTheApes.bin,207,72,43,29,452,121,151,0.9104
Riddle of the Sphinx.bin,171,90,76,14,511,94,142,0.9451
River Patrol.bin,64,116,64,52,690,209,149,0.9391
River Raid (16k Version).bin,800,232,200,32,1460,264,144,0.9338
River_tw.bin,200,57,49,8,361,66,144,0.9354
Rivraid2.bin,861,215,178,37,823,278,151,0.9385
Road Runner.bin,745,190,139,51,1133,317,151,0.9478
Robin Hood.bin,280,117,95,22,569,245,149,0.9374
robnhood.bin,280,117,95,22,569,245,149,0.9374
Robot Fight.bin,128,128,91,37,374,96,145,0.9446
Robot Tank.bin,481,94,89,5,498,149,150,0.9354
Roc n' Rope.bin,281,214,111,103,670,258,149,0.9364
Room of Doom.bin,243,112,98,14,370,95,139,0.9384
RubiksCube3D.bin,295,137,113,24,217,76,142,0.9249
RushHour.BIN,224,82,59,23,263,104,136,0.9388
Saboteur.bin,315,251,212,39,585,102,151,0.9393
sagent.bin,225,63,61,2,370,81,144,0.9370
Save Our Ship.bin,295,100,88,12,305,103,136,0.9269
SaveMary_NTSC.bin,458,306,286,20,794,305,151,0.9455
SaveTheWhales.BIN,175,33,27,6,291,58,132,0.9611
scsi130-cge2k1.bin,193,51,45,6,156,149,132,0.8694
scsi130sp-cge2k1.bin,193,51,45,6,156,149,132,0.8694
scsi200_NTSC.bin,228,63,60,3,183,90,133,0.8760
SCUDIV_P.BIN,157,127,103,24,373,138,142,0.9465
Sea Hawk (CCE).bin,259,43,34,9,310,108,136,0.9488
Sea Hunt.bin,157,128,104,24,374,138,142,0.9466
Sea Monster (PAL).bin,242,101,90,11,345,66,140,0.9451
seantsc.bin,180,68,52,16,276,101,141,0.9330
Seaquest.bin,352,75,62,13,360,83,145,0.9372
SECRETQ.BIN,769,249,177,72,1440,344,151,0.9240
Seesaw (Taiwan).bin,149,34,32,2,273,76,145,0.9595
Sentinel.bin,490,331,252,79,832,251,151,0.9305
Shark Attack.bin,209,35,24,11,451,66,144,0.9498
shootacd.bin,695,312,253,59,881,390,151,0.9150
Shootin' Gallery.bin,292,61,48,13,290,71,147,0.9374
Shuttle Orbiter.bin,180,47,35,12,287,102,137,0.9330
Sinistar.bin,221,132,101,31,387,158,147,0.9536
Sir Lancelot.bin,415,216,193,23,503,257,148,0.9430
Skateboardin'.bin,292,65,49,16,609,145,147,0.9209
Skeet Shoot (1).bin,109,39,25,14,223,43,121,0.9463
Skeet Shoot (2).bin,218,78,50,28,446,86,121,0.9463
skel-pal.bin,182,43,24,19,459,120,142,0.9198
skeleton.bin,195,43,24,19,431,111,140,0.9199
SkelPlus.bin,208,50,32,18,446,110,143,0.9203
SkelPPAL.bin,215,50,32,18,473,123,140,0.9265
Ski Hunt.bin,231,76,53,23,310,91,149,0.9298
Ski Run.bin,204,49,46,3,305,113,142,0.9426
Skiing (1).bin,91,22,18,4,202,46,137,0.9399
Skiing (2).bin,182,44,36,8,404,92,137,0.9399
Skiing (32 in 1) (PAL).bin,91,22,18,4,200,46,135,0.9408
Sky Diver (32 in 1) (PAL).bin,117,51,33,18,160,38,128,0.9453
Sky Diver.bin,116,51,33,18,156,39,130,0.9459
Sky Jinks (4k version).bin,234,64,40,24,398,94,137,0.9431
Sky Patrol (Prototype).bin,321,128,84,44,571,205,151,0.9308
Sky Skipper.bin,245,97,87,10,332,108,135,0.9316
Slot Machine (32 in 1) (PAL).bin,101,40,28,12,226,58,120,0.9503
Slot Machine.bin,101,40,28,12,224,58,121,0.9509
Slot Racers (32 in 1) (PAL).bin,91,99,75,24,161,64,123,0.9299
Slot Racers - Maze (1).bin,93,97,74,23,160,65,123,0.9298
Slot Racers - Maze (2).bin,186,194,148,46,320,130,123,0.9298
SMRFSAVE.BIN,611,149,119,30,668,273,144,0.9362
Smurfs - Rescue in Gargamel's Castle.bin,501,160,137,23,743,139,148,0.9332
Snail Against Squirrel (CCE).bin,177,148,91,57,382,130,143,0.9330
Sneek n Peek.bin,227,94,60,34,391,111,146,0.9401
Snoopy and the Red Baron.bin,493,215,155,60,704,186,149,0.9391
snow_wht.bin,423,178,125,53,536,218,145,0.9140
snthcart.bin,200,127,124,3,439,182,149,0.8993
Soccer (Unlicensed).bin,216,97,91,6,261,126,135,0.9325
Solar Fox.bin,404,205,201,4,541,295,148,0.9449
Solar Storm.bin,264,88,66,22,369,84,150,0.9413
Solaris.bin,722,214,116,98,1122,416,151,0.9326
SolarPlexus.bin,241,109,87,22,235,131,139,0.9400
Sorcerer's Apprentice.bin,391,177,155,22,514,241,150,0.9397
Sorcerer.bin,176,98,82,16,347,113,142,0.9250
SP-DL.BIN,491,135,105,30,373,89,142,0.9679
Space Attack.bin,197,85,59,26,296,168,139,0.9405
Space Canyon.bin,175,70,49,21,344,72,140,0.9489
Space Cavern.bin,174,71,49,22,361,72,142,0.9490
Space Invaders.bin,193,49,45,4,394,99,140,0.9428
Space Jockey (32 in 1) (PAL).bin,106,36,28,8,177,40,136,0.9409
Space Jockey (4K version).bin,212,60,50,10,362,82,137,0.9366
Space Jockey.bin,106,30,25,5,181,41,137,0.9366
Space Raid.bin,319,58,54,4,292,94,137,0.9417
Space Robot.bin,129,126,90,36,373,95,145,0.9446
Space Shuttle.bin,432,116,93,23,737,143,151,0.9252
Space Tunnel (PAL).bin,219,97,86,11,797,93,141,0.9479
Space Tunnel (Taiwan).bin,183,84,75,9,755,66,137,0.9412
Space War (32 in 1) (PAL).bin,84,62,53,9,217,34,126,0.9359
Space War (4k Version).bin,166,124,106,18,428,66,126,0.9359
Space War.bin,83,62,53,9,214,33,126,0.9359
SpaceAdventure_Zellers.BIN,245,112,95,17,364,54,144,0.9494
Spacechase.bin,160,70,61,9,400,107,135,0.9271
SpaceMaster X-7.bin,204,84,66,18,339,60,132,0.9489
Spider Fighter (16k Version).bin,1020,324,256,68,1304,256,145,0.9371
Spider Fighter.bin,255,81,64,17,326,64,145,0.9371
Spider-Man.bin,193,67,38,29,399,90,146,0.9443
Spiderdroid.bin,299,176,172,4,332,121,135,0.9448
spidermz.BIN,173,86,76,10,307,126,140,0.9429
Spike's Peak.bin,497,93,89,4,666,171,143,0.9451
Spitfire Attack.bin,227,122,98,24,464,109,134,0.9506
Springer.bin,104,135,111,24,678,470,149,0.9343
Sprintmaster.bin,273,184,138,46,826,242,151,0.9391
Spy Hunter.bin,296,94,51,43,789,141,151,0.9384
Squeeze Box.bin,188,63,60,3,364,108,143,0.9299
Squoosh.bin,109,39,30,9,128,32,111,0.9737
Sssnake.bin,189,39,37,2,359,132,135,0.9494
Stampede (1).bin,147,37,20,17,177,40,134,0.9427
Stampede (2).bin,294,74,40,34,354,80,134,0.9427
Stampede (32 in 1) (PAL).bin,147,37,20,17,177,40,134,0.9426
Star Fox.bin,232,103,89,14,410,117,141,0.9418
Star Raiders.bin,240,75,47,28,520,98,146,0.9567
Star Ship - Outer Space (1).bin,68,53,37,16,203,34,123,0.9403
Star Ship - Outer Space (2).bin,136,106,74,32,406,68,123,0.9403
Star Strike.bin,199,109,77,32,334,137,146,0.9446
Star Trek - Strategic Operations Simulator.bin,264,133,96,37,857,192,151,0.9364
Star Voyager.bin,172,139,124,15,409,88,137,0.9405
Star Wars - Death Star Battle.bin,376,228,210,18,716,260,150,0.9395
Star Wars - Empire Strikes Back.bin,160,60,51,9,401,123,145,0.9420
Star Wars - Jedi Arena.bin,281,103,73,30,294,86,140,0.9364
Star Wars - The Arcade Game.bin,240,120,102,18,758,193,151,0.9408
STAREMPR.BIN,160,60,51,9,401,123,145,0.9420
Stargate (1).bin,490,290,256,34,1570,288,151,0.9436
STARGN.BIN,276,109,72,37,394,115,138,0.9418
Starmaster.bin,180,73,66,7,311,82,146,0.9377
Starpath - Communist Mutants From Space.bin,351,127,85,42,541,179,149,0.9559
Starpath - Dragonstomper.bin,563,305,251,54,1335,549,151,0.9494
Starpath - Escape from the Mindmaster.bin,905,249,191,58,1322,460,151,0.9658
Starpath - Fireball.bin,243,73,55,18,411,172,146,0.9552
Starpath - Frogger (Official version by Sega).bin,405,116,73,43,389,168,150,0.9501
Starpath - Killer Satellites.bin,385,124,104,20,616,135,151,0.9302
Starpath - Party Mix.bin,945,222,179,43,1207,270,151,0.9537
Starpath - Phaser Patrol.bin,282,106,92,14,580,132,149,0.9562
Starpath - Rabbit Transit.bin,560,120,79,41,414,180,148,0.9540
Starpath - Suicide Mission.bin,199,133,106,27,339,193,148,0.9673
Starpath - Survival Island.bin,1224,360,285,75,1325,434,151,0.9584
Starpath - Sweat! - The Decathalon Game.bin,556,96,82,14,611,241,145,0.9769
Starpath - Sword Of Saros.bin,340,177,104,73,595,194,146,0.9542
STARTREK.BIN,264,133,96,37,857,192,151,0.9364
STARVYGR.BIN,172,139,124,15,409,88,137,0.9405
Steeplechase (1).bin,86,53,49,4,191,35,128,0.9363
Steeplechase (2).bin,172,106,98,8,382,70,128,0.9363
Stell-A-Sketch.bin,214,120,91,29,313,73,140,0.8451
Stellar Track.bin,93,130,125,5,328,157,141,0.9400
Stntman.bin,127,32,18,14,359,151,144,0.9352
Strategy X.bin,145,134,107,27,430,180,147,0.9448
StratOGemsDeluxe.bin,782,222,177,45,610,386,148,0.9742
Strawberry Shortcake Musical Match-Ups.bin,223,93,72,21,205,64,146,0.9203
Street Racer - Speedway II (2).bin,214,268,220,48,392,66,127,0.9475
Stronghold.bin,215,73,56,17,396,81,144,0.9415
stunt.bin,105,54,41,13,157,23,118,0.9454
Sub Scan.bin,271,93,73,20,311,166,144,0.9414
Submarine Commander.bin,252,125,108,17,454,106,140,0.9421
Subterrenea.bin,223,132,101,31,702,226,150,0.9346
Summer Games.bin,1035,205,160,45,1066,384,151,0.9183
Super Baseball.bin,442,175,142,33,859,325,151,0.9573
Super Box (CCE).bin,757,290,221,69,600,232,149,0.8848
Super Breakout.bin,129,35,30,5,401,73,138,0.9467
Super Challenge Baseball.bin,190,53,31,22,375,103,145,0.9432
Super Challenge Football.bin,308,72,50,22,328,105,143,0.9459
Super Cobra.bin,394,160,117,43,558,172,147,0.9146
Super Ferrari.bin,279,79,46,33,288,72,146,0.9478
Super Futebol.bin,268,147,138,9,424,225,146,0.9499
Superman (1).bin,160,114,62,52,408,114,141,0.9419
Suprman2.bin,160,114,62,52,407,115,144,0.9431
Surf's Up.bin,369,279,168,111,448,118,150,0.9235
Surfer's Paradise - But Danger Below!.bin,169,81,58,23,406,111,145,0.9440
Surround (32 in 1) (PAL).bin,92,28,17,11,179,63,116,0.9426
Surround (4k version).bin,182,56,34,22,358,126,118,0.9437
Survival Run.bin,210,120,92,28,286,106,146,0.9340
SWARCADE.BIN,240,120,102,18,758,193,151,0.9408
Swoops! (v0.96) (PAL).bin,270,74,64,10,345,77,147,0.9347
Swoops! (v0.96).bin,271,74,64,10,346,73,145,0.9349
SwordQuest - Earthworld.bin,414,150,125,25,437,268,150,0.9226
SwordQuest - Fireworld.bin,445,252,203,49,525,298,145,0.9443
SwordQuest - Waterworld.bin,429,180,131,49,431,212,151,0.9390
T.F. Space Invaders.bin,196,48,44,4,392,98,141,0.9431
Tacscan.bin,242,65,47,18,436,96,147,0.9411
Tanks But No Tanks.bin,161,65,57,8,457,156,143,0.9469
Tapeworm.bin,162,36,32,4,317,70,132,0.9343
Tapper.bin,650,160,86,74,663,150,150,0.9327
Targ (CBS).bin,150,49,45,4,294,51,137,0.9595
Task Force.bin,175,107,99,8,311,120,138,0.9462
Tax Avoiders.bin,377,200,176,24,459,251,150,0.9337
Taz.bin,217,215,158,57,449,298,150,0.9430
Teddy Apple.bin,286,69,40,29,312,75,139,0.9334
telepathy.bin,308,105,91,14,645,175,151,0.9296
tempst26.bin,262,53,39,14,668,176,145,0.9548
Tennis (1).bin,117,55,33,22,202,33,135,0.9468
Tennis (2).bin,234,110,66,44,404,66,135,0.9468
Tennis (32 in 1) (PAL).bin,117,55,33,22,200,34,133,0.9475
Test.bin,20,6,4,2,11,6,40,0.3022
testcart.bin,144,49,45,4,167,603,127,0.9276
Tetris 2600.bin,252,25,16,9,184,31,114,0.9220
Texas Chainsaw Massacre.bin,271,40,20,20,322,72,143,0.9468
This Planet Sucks.bin,328,120,106,14,239,136,140,0.9422
Threshhold.bin,202,99,89,10,381,120,143,0.9327
Thrust+.bin,352,317,226,91,887,398,151,0.9029
Thrust.bin,352,317,226,91,887,398,151,0.9029
Thunderground.bin,185,59,52,7,380,110,137,0.9386
Time Machine.bin,160,78,59,19,332,174,143,0.9470
Time Pilot (1).bin,370,151,108,43,450,118,148,0.9474
Time Race.bin,119,44,36,8,324,60,147,0.9391
Time Warp.bin,200,169,156,13,369,131,139,0.9431
Title Match Pro Wrestling (1).bin,448,128,103,25,596,169,149,0.9420
Tom Boy.bin,245,79,61,18,307,60,142,0.9401
Tomarc the Barbarian.bin,439,136,121,15,747,339,144,0.9406
Tooth Protectors.bin,478,189,162,27,486,234,147,0.9387
Towering Inferno.bin,261,163,88,75,319,117,140,0.9446
Tps.bin,328,120,106,14,239,136,140,0.9422
Track and Field.bin,1046,407,290,117,1229,540,150,0.9360
Traffic.bin,220,78,62,16,313,151,149,0.9452
Treasure Below (Video Gems, Thomas Jentzsch) (NTSC).bin,231,65,51,14,358,121,144,0.9489
treat.bin,261,106,87,19,235,116,141,0.9386
treat_ntsc.bin,227,101,79,22,262,143,136,0.9368
Trick Shot.bin,229,55,36,19,293,113,144,0.9346
Tron - Deadly Discs.bin,236,44,38,6,352,122,144,0.9470
Tuby Bird.bin,296,82,76,6,408,113,139,0.9470
Tunlrunr.bin,576,195,107,88,864,222,151,0.9036
Turmoil.bin,258,85,65,20,354,67,143,0.9420
Tutankham.bin,249,114,76,38,657,206,151,0.9341
UFO Patrol.bin,244,89,72,17,347,121,144,0.9392
Universal Chaos (PAL).bin,160,97,88,9,379,69,140,0.9525
UniversalProto.Bin,494,141,89,52,639,188,148,0.9450
UnknownActivision1_NTSC.bin,181,69,37,32,104,40,134,0.8585
UnknownActivision2_NTSC.bin,261,161,123,38,413,100,135,0.9461
Up n Down.bin,223,90,68,22,677,96,147,0.9343
Vanguard.bin,372,148,91,57,983,188,147,0.9453
VaultAssault.bin,233,116,107,9,258,95,134,0.9086
VenetianBlinds_NTSC.bin,76,24,22,2,52,12,101,0.7060
Venture.bin,135,65,46,19,357,75,148,0.9336
Vg_survi.bin,217,103,90,13,334,79,139,0.9499
Video Checkers.bin,157,116,105,11,394,159,141,0.9431
Video Chess.bin,97,74,67,7,454,114,144,0.9435
Video Cube (CCE).bin,288,109,83,26,295,98,139,0.9401
Video Jogger.bin,232,53,44,9,347,96,133,0.9341
Video Olympics - Pong Sports (1).bin,75,77,57,20,207,47,135,0.9451
Video Olympics - Pong Sports (2).bin,150,154,114,40,414,94,135,0.9451
Video Pinball.bin,193,106,97,9,375,74,138,0.9376
Video Reflex.bin,252,134,129,5,258,133,132,0.9442
Video Time Machine.bin,108,95,86,9,133,40,145,0.8776
Vidpin.bin,193,106,97,9,375,74,138,0.9376
VultureAttack_KTel.bin,319,86,83,3,276,68,142,0.9431
Wabbit.bin,436,114,104,10,295,76,136,0.9402
Walker.bin,199,104,84,20,209,162,145,0.9250
Wall Ball.bin,230,143,107,36,307,115,142,0.9385
Wall Defender.bin,141,115,109,6,374,96,144,0.9354
Warlords.bin,226,83,75,8,458,151,130,0.9344
Warplock.bin,128,110,85,25,616,60,140,0.9230
warworm.bin,252,55,33,22,333,146,137,0.9435
Weltraum Tunnel.bin,200,98,69,29,416,84,149,0.9426
Wing War.bin,267,151,96,55,733,167,150,0.9380
Wings_6-3-83.bin,731,88,67,21,740,197,151,0.9068
Winter Games.bin,789,228,133,95,1124,395,151,0.9394
Wizard of Wor.bin,233,85,68,17,473,80,141,0.9423
Wizard.bin,112,48,26,22,218,56,129,0.9436
Word Zapper.bin,134,68,51,17,286,99,147,0.9289
words.bin,162,72,67,5,241,87,143,0.9522
World End.bin,219,90,74,16,283,143,139,0.9448
Worm War I.bin,214,65,51,14,324,64,132,0.9462
X-Doom.bin,320,59,56,3,296,91,138,0.9409
X-Man (1).bin,245,110,90,20,302,178,143,0.9341
Xenophob.bin,513,368,311,57,1242,418,151,0.9402
Xevious.bin,199,85,64,21,287,131,147,0.9597
Yahtzee.bin,188,89,69,20,241,76,138,0.8896
Yar's Revenge (1).bin,228,156,79,77,436,100,141,0.9467
Z-Tack.bin,151,62,37,25,294,130,143,0.9346
Zaxxon.bin,318,158,110,48,642,172,141,0.9370
Zoo Fun.bin,176,75,59,16,317,91,142,0.9269
